indonesien	indonesia
reagieren	reaccionar
bedingung	condición
paolo	paolo
tagebuch	diario
ethik	ética
ausgewählte	seleccionados
britisch	británico
britisch	británicos
entdecken	descubrir
entdecken	descubra
entdecken	descubriendo
entdecken	descubre
berücksichtigen	enterados
gestapo	gestapo
beginnend	empezando
beginnend	comenzando
frequenz	frecuencia
lit	lit
auffällig	llamativo
seltene	raros
seltene	raras
marshall	marshall
handwerk	artesanía
most	most
most	mosto
houston	houston
adrian	adrian
reichlich	abundante
gefallenen	caído
gefallenen	caídos
kaffee	café
gedenkstätte	memorial
agent	agente
zagreb	zagreb
fokus	enfoque
fokus	foco
nations	nations
verbesserungen	mejoras
gegenseitig	mutuamente
schien	parecía
grey	grey
krakau	cracovia
gesendet	publicado
gesendet	enviado
zypern	chipre
anleitung	guía
jeff	jeff
geezer	geezer
staatsbürgerschaft	ciudadanía
staatsbürgerschaft	nacionalidad
zwang	coerción
zwang	coacción
unterart	subespecie
komplexe	complejos
verbündeten	aliado
verbündeten	aliados
truppe	tropa
türme	torres
türme	torre
hut	sombrero
verbleib	permanencia
abgeschafft	suprimido
milch	leche
kommerziellen	comerciales
jon	jon
schmitt	schmitt
bestände	existencias
hills	hills
drittes	tercera
drittes	tercer
drittes	tercero
anfänglich	inicialmente
beeinflussen	afectar
bug	bug
meilen	millas
farm	granja
gera	gera
motorrad	moto
lutherische	luterana
aktueller	actual
peer	peer
wellen	olas
maßstab	escala
hinterließ	dejó
landete	aterrizó
car	car
sopran	soprano
philosophische	filosófico
klassiker	clásico
burgund	borgoña
partnerschaft	asociación
erfordert	requiere
erfordert	requerido
pauli	pauli
brot	pan
ukrainischen	ucraniano
xiii	xiii
lehren	lecciones
marseille	marsella
hugh	hugh
erlebt	experimentado
chen	chen
leon	leon
french	french
duden	duden
beethoven	beethoven
mönche	monjes
krefeld	krefeld
tommy	tommy
ungarisch	húngaro
rgb	rgb
görlitz	görlitz
glatt	suave
glatt	liso
beauftragte	delegada
aussicht	perspectiva
beantworten	responder
erwerb	adquisición
passage	pasaje
stiegen	subieron
run	run
anime	anime
kairo	cairo
haltestelle	parada
bittet	invita
bittet	pide
olaf	olaf
bewusstsein	conciencia
erlauben	permitir
porträts	retratos
avenue	avenida
motors	motors
small	small
schumann	schumann
remix	remix
trikot	camiseta
lorenzo	lorenzo
gescheitert	fracasado
renate	renate
masters	masters
opern	ópera
tschechisch	checo
zugewiesen	asignado
zugewiesen	asignados
grundlegend	fundamental
kriegen	guerras
reifen	neumáticos
wolfram	tungsteno
roberts	roberts
komitee	comite
komitee	comité
hirsch	ciervo
umstand	circunstancia
unterarten	subespecies
ermittlungen	investigaciones
speicher	memoria
nancy	nancy
verwechseln	confundir
hunter	hunter
verschieden	diferentes
verschieden	diferente
get	get
krieger	guerrero
umstände	circunstancias
systematisch	sistemático
systematisch	sistemática
eichstätt	eichstätt
eastern	eastern
selbstverlag	selbstverlag
delta	delta
armin	armin
brockhaus	brockhaus
ivan	ivan
erwünscht	deseable
erwünscht	deseada
konzentriert	concentrado
konzentriert	centrado
edwin	edwin
kent	kent
matthäus	mateo
bond	bond
aluminium	aluminio
dimension	dimensión
schönheit	belleza
sauerstoff	oxígeno
erstellte	creó
mitchell	mitchell
marion	marion
rasse	raza
ingolstadt	ingolstadt
inschriften	inscripciones
zähne	dientes
cottbus	cottbus
gültig	válido
gültig	valido
bekamen	obtuvieron
statthalter	gobernador
sri	sri
systematische	sistemático
systematische	sistemática
denkbar	concebible
denkbar	imaginable
satelliten	satélites
satelliten	satélite
umgehen	eludir
symbole	símbolos
theo	theo
medaillen	medallas
abbruch	interrupción
abbruch	demolición
spannungen	tensión
spannungen	tensiones
resultat	resultado
bricht	rompe
sony	sony
verarbeitung	procesamiento
verarbeitung	transformación
sechste	sexto
sechste	sexta
empfohlen	recomendada
empfohlen	recomendado
five	five
vernichtet	destruido
frühling	primavera
romanischen	románica
raf	raf
akzeptieren	aceptar
gräber	tumbas
ansbach	ansbach
renovierung	renovación
collins	collins
herstellen	fabricación
massiven	masivo
terry	terry
gleichung	ecuación
sockel	zócalo
sockel	casquillo
sockel	socket
erlaubte	permitido
vergeblich	vano
mögen	gustar
schulze	schulze
traditionen	tradiciones
behauptete	afirmó
behauptete	supuesta
six	six
flag	flag
hunde	perros
krebs	cáncer
verfolgen	perseguir
virus	virus
energy	energy
fett	negrita
direkter	directo
anzeigen	anuncios
anzeigen	mostrar
alain	alain
blättern	hojas
angetrieben	accionado
angetrieben	impulsado
wiederholen	repita
wiederholen	repetir
reformierte	reformado
historique	historique
astronomie	astronomía
decke	manta
achim	achim
schritte	pasos
dominiert	dominado
dominiert	domina
dominiert	dominadas
geschafft	conseguido
geschafft	logrado
michail	mikhail
michail	mijail
linden	linden
globe	globe
ulrike	ulrike
nicholas	nicholas
jubiläum	aniversario
jubiläum	aniversarios
schnabel	pico
übertrug	transfirió
schriftlich	escrito
palästina	palestina
klärung	clarificación
klärung	aclaración
wilfried	wilfried
verfolgte	perseguidos
angewandt	aplicado
zehnten	décima
zehnten	décimo
eingeleitet	iniciada
eingeleitet	iniciado
beobachter	observador
beobachter	observadores
bilanz	balance
medical	medical
fürth	fürth
indirekt	indirecto
indirekt	indirecta
indirekt	indirectamente
mtv	mtv
alias	alias
bestätigung	confirmación
mühlen	molinos
wiederherstellen	restaurar
massaker	masacre
suffix	sufijo
rudolph	rudolph
umgangssprachlich	coloquialmente
matrix	matriz
ähnlichkeit	similitud
ähnlichkeit	semejanza
thematik	temática
verteidigte	defendió
verteidigte	defendido
empfehlung	recomendación
bedrohung	amenaza
einweihung	inauguración
landkreise	condados
landkreise	comarcas
vollendet	completado
landung	aterrizaje
fertigte	fabricó
statistischen	estadística
dallas	dallas
offensive	ofensiva
fein	fino
pole	pole
herman	herman
besiegt	derrotado
krause	krause
entwürfe	borradores
entwürfe	diseños
schwimmen	natación
early	early
abkürzungen	abreviaturas
protest	protesta
messina	messina
bsg	zepa
kugel	bola
kugel	esfera
kosovo	kosovo
delegation	delegación
färbung	coloración
water	water
pest	peste
pest	plaga
genehmigt	autorizado
genehmigt	aprobado
genehmigt	aprobada
universum	universo
gespräche	conversaciones
biathlon	biatlón
wärme	calor
ordentlichen	ordinario
kommerzielle	comercial
korrigieren	corregir
mechanische	mecánicos
mechanische	mecánica
moor	pantano
erfüllung	cumplimiento
schach	ajedrez
ward	ward
einheitlich	uniforme
ehrungen	honores
auftauchen	emerger
einbau	instalación
breitengrad	latitud
commonwealth	commonwealth
hohenzollern	hohenzollern
klang	sonido
verpflichtete	comprometió
malta	malta
sitzung	reunión
sitzung	sesión
bolivien	bolivia
schwerpunkte	prioridades
wood	wood
seoul	seúl
verpflichtung	compromiso
verpflichtung	obligación
leiche	cadáver
warner	warner
verträge	tratados
verträge	contratos
abschied	despedida
perfekt	perfecto
perfekt	perfecta
kommunisten	comunistas
eingegangen	recibidas
eingegangen	recibida
eingegangen	recibido
ngc	ngc
definieren	definir
augustin	augustin
gotischen	gótico
organ	órgano
konto	cuenta
inhaftiert	encarcelado
busse	autobuses
mineral	mineral
mixed	mixto
work	work
holger	holger
kommissar	comisionado
kommissar	comisario
erlernte	aprendí
erlernte	aprendido
präsentierte	presentó
dream	dream
aktien	compartir
aktien	acciones
grammatik	gramática
lustig	divertido
landshut	landshut
silver	silver
case	case
spanier	españoles
upper	upper
filter	filtro
filter	filtros
hölle	infierno
beat	beat
meta	meta
charakteristisch	característico
grade	grados
geh	ve
mönch	monje
plateau	meseta
befreien	liberar
umgestaltet	remodelado
amateur	amateur
amateur	aficionado
nachbarschaft	vecindad
nachbarschaft	barrio
staatsanwaltschaft	fiscalía
popularität	popularidad
oberhausen	oberhausen
laurent	laurent
wolfenbüttel	wolfenbüttel
konsequenzen	consecuencias
belgische	belga
rechtsprechung	jurisprudencia
bakterien	bacterias
martha	martha
channel	channel
übersetzen	traducir
übersetzen	traducción
erhard	erhard
hunderte	cientos
hunderte	centenares
trainiert	entrenado
trainiert	entrena
trainiert	entrenando
börse	bolsa
kings	kings
taunus	taunus
angefangen	empezando
angefangen	comenzando
genua	génova
hours	hours
gleis	vía
cook	cook
exzellent	excelente
juristen	juristas
juristen	abogados
rum	ron
sekunde	segundo
warren	warren
nigeria	nigeria
its	its
orient	oriente
gespeichert	guardado
christiane	christiane
bezirke	distritos
paare	parejas
blood	blood
set	set
rechtfertigen	justificar
protagonisten	protagonistas
störung	desorden
rekonstruktion	reconstrucción
administratoren	administradores
gelernt	aprendido
gefüllt	rellena
gefüllt	lleno
gefüllt	llenado
auslegung	interpretación
haushalt	presupuesto
marschall	mariscal
redundant	redundante
prediger	predicador
installation	instalación
kaspar	kaspar
ecken	esquinas
ecken	rincones
speichern	guardar
zurückkehren	volver
schuss	tiro
schuss	disparo
freundlich	amistosa
freundlich	amigable
freundlich	amistoso
gehäuse	carcasa
zylinder	cilindro
zylinder	cilindros
vorschlagen	sugerir
portugiesisch	portugués
wähler	votantes
wähler	electores
reduzieren	reducir
populär	popular
populär	populares
fotografien	fotografías
days	days
village	village
nachteil	desventaja
gramm	gramos
gramm	gramo
abgekürzt	abreviado
wände	paredes
begleitung	acompañamiento
abwehr	defensas
genres	géneros
konkurrenten	competidores
wiederholte	repetido
chancen	oportunidades
stören	molestar
gastgeber	anfitrión
denkt	piensa
kämpfer	combatientes
kämpfer	luchador
kämpfer	combatiente
charlottenburg	charlottenburg
blumen	flores
würdest	harías
wünschen	deseo
wünschen	desear
venus	venus
schema	esquema
alexandra	alejandra
split	split
unruhen	disturbios
rosen	rosas
keith	keith
beigetragen	contribuido
fis	fis
renommierten	prestigioso
renommierten	prestigiosas
renommierten	prestigiosa
tante	tía
einstellungen	configuración
einstellungen	preferencias
tennisspieler	tenista
selbständig	autónomo
selbständig	independiente
wohn	residencial
meisterin	campeona
nazi	nazi
pfarrhaus	rectoría
hudson	hudson
sorte	variedad
fdl	fdl
diktatur	dictadura
lehrerin	maestra
lehrerin	profesora
lehrerin	profe
nase	nariz
ebert	ebert
finanzen	finanzas
jungfrau	virgen
marsch	marcha
fresken	frescos
brooklyn	brooklyn
verbandsgemeinde	verónica
tel	tel
herder	herder
doppelte	doble
heine	heine
teilchen	partículas
kong	kong
achtung	atención
achtung	respeto
spendete	donó
salon	salon
buddhismus	budismo
sauer	enojado
zufall	coincidencia
jay	jay
suite	suite
massive	massive
massive	masiva
kommend	eyaculación
salz	sal
monaco	mónaco
guillaume	guillaume
export	exportación
kollege	colega
portugiesische	portuguesa
portugiesische	portugués
future	future
helen	helen
bretagne	bretaña
railroad	railroad
entfernte	remoto
volumen	volumen
normandie	normandía
larry	larry
ghana	ghana
himmelfahrt	ascensión
yale	yale
find	find
regierungen	gobiernos
deep	deep
manhattan	manhattan
talsperre	presa
talsperre	embalse
volleyball	voleibol
sortiert	ordenada
sortiert	ordenados
urlaub	vacaciones
neffe	sobrino
plural	plural
baptiste	baptiste
julie	julie
oldid	oldid
inspiriert	inspirada
inspiriert	inspirado
rafael	rafael
regina	regina
feind	enemigo
niedergang	decadencia
klage	demanda
schauspielhaus	schauspielhaus
fortschritt	progreso
teich	estanque
schickte	envió
untersuchte	investigado
untersuchte	examinó
track	track
dachau	dachau
sms	sms
anatomie	anatomía
strauss	strauss
leere	vacío
raketen	misiles
steuer	impuesto
steuer	impuestos
bull	bull
irene	irene
aussterben	extinción
aussprache	pronunciación
perry	perry
aufgeben	rendirse
synthese	síntesis
trainierte	entrenó
culture	culture
vermieden	evitado
montag	lunes
kurve	curva
goldener	dorado
rettung	rescate
fotografiert	fotografiado
ems	ems
empfänger	receptor
empfänger	destinatario
iucn	uicn
kaiserliche	imperial
warf	tiró
warf	lanzó
konsequent	coherente
konsequent	consecuente
erläuterung	explicación
edith	edith
gewerkschaften	sindicatos
beton	hormigón
playoffs	playoffs
holen	traer
jünger	discípulos
tatsachen	hechos
gotische	gótico
bois	bois
glücklich	feliz
demokraten	demócratas
anbieten	ofrecer
rakete	cohete
rakete	misil
ausgleich	compensación
wallace	wallace
kapital	capital
unverständlich	incomprensible
verwechselt	confundido
abschaffung	supresión
abschaffung	abolición
facto	facto
helena	helena
unterhalten	entretenido
unterhalten	entretener
anwesend	presente
moses	moisés
champion	campeón
champion	campeon
singapur	singapur
pablo	pablo
baut	construye
mülheim	mülheim
toulouse	toulouse
verlegung	reubicación
verlegung	traslado
neunten	novena
neunten	noveno
muslime	musulmanes
muslime	musulmán
heyne	heyne
stille	silencio
christlich	cristiano
ellen	ellen
zitate	citas
sternen	estrellas
places	places
arno	arno
namensgeber	epónimo
bemerkungen	observaciones
cleveland	cleveland
sinnlos	inútil
santos	santos
geografische	geográfico
gefangene	prisioneros
gefangene	presos
geiger	violinista
aufrecht	vertical
freud	freud
minor	minor
god	god
situationen	situaciones
kontrolliert	supervisa
kontrolliert	controlado
piper	piper
besuchern	visitantes
algerien	argelia
kanzler	canciller
provence	provence
provence	provenza
jülich	jülich
kanonen	cañones
streitigkeiten	controversias
streitigkeiten	disputas
erhob	levantó
kenneth	kenneth
passagen	pasajes
revue	revue
franziska	franziska
newton	newton
aufführungen	espectáculos
aufführungen	representaciones
katastrophe	catástrofe
mdb	mdb
formulierungen	formulaciones
charaktere	personajes
torhüter	portero
summer	summer
lords	lores
neutralität	neutralidad
after	after
ignaz	ignaz
true	true
automatische	automático
automatische	automática
basler	basilea
quartett	cuarteto
flandern	flandes
viola	viola
bristol	bristol
cinema	cinema
namibia	namibia
bergwerk	mina
political	political
verteilen	repartir
verteilen	distribuir
univ	univ
salomon	salomón
greifen	agarrar
litt	sufrido
litt	sufrió
litt	sufría
erika	erika
konvention	convención
haase	haase
abwarten	esperar
but	but
atlantik	atlántico
pont	pont
zusammenbruch	colapso
nominierungen	nominaciones
draußen	afuera
marina	marina
nich	vamo
gehalt	salario
sauber	limpio
sauber	limpia
when	when
flöte	flauta
düren	düren
forstwirtschaft	silvicultura
ideologie	ideología
herzogin	duquesa
metropolitan	metropolitana
metropolitan	metropolitan
harrison	harrison
dietmar	dietmar
diana	diana
nazis	nazi
nazis	nazis
ron	ron
landwirt	agricultor
mehrzahl	plural
regierungszeit	reinado
heilig	santo
heilig	sagrado
geholfen	ayudado
sorge	preocupación
malaysia	malasia
augustus	augustus
strahlung	radiación
eintragung	inscripción
vera	vera
substanzen	substancias
substanzen	sustancias
internen	interno
internen	internos
alexandria	alejandría
ergänzungen	adiciones
ergänzungen	suplementos
psychiatrie	psiquiatría
ohren	orejas
ohren	oídos
trennt	separa
bush	bush
variiert	varía
variiert	varia
vorherige	anterior
vorherige	anteriores
bordeaux	burdeos
erscheinungsbild	apariencia
elite	élite
elite	elite
elias	elías
elias	elias
astronomen	astrónomos
erbte	heredó
hochwasser	inundaciones
vertraut	familiarizado
abwesenheit	ausencia
bibliographie	bibliografía
rallye	rally
willkommen	bienvenidos
willkommen	bienvenido
kraus	kraus
bezahlen	pagar
automobil	automóvil
einstein	einstein
motivation	motivación
einnahme	ingestión
ungeeignet	inadecuado
ungeeignet	inapropiado
apostel	apóstol
amphoe	amphoe
islamische	islámico
finnische	finlandés
spalten	columnas
wolfsburg	wolfsburg
singer	singer
widmen	dedicar
aufsicht	supervisión
middle	middle
ancient	ancient
feder	pluma
gotteshaus	iglesia
orthodoxe	ortodoxo
orthodoxe	ortodoxos
orthodoxe	ortodoxa
ausgegeben	gastado
gewährt	concedida
gewährt	otorgado
gewährt	concedido
eurovision	eurovisión
gutachten	dictámenes
vermerkt	anotado
bock	bock
winkler	winkler
match	match
repräsentiert	representa
repräsentiert	representado
erneuerung	renovación
entzogen	despojado
firefox	firefox
colin	colin
phasen	etapas
phasen	fases
kombiniert	combina
kombiniert	combinado
brecht	brecht
olga	olga
prägte	acuñó
reichsbahn	reichsbahn
industrielle	industrial
het	het
attentat	atentado
musikvideo	videoclip
gezeichnet	firmado
gezeichnet	suscrito
gezeichnet	dibujado
gefühle	sentimientos
gefühle	sensaciones
atlantic	atlantic
steffen	steffen
sozialistische	socialistas
sozialistische	socialista
verweise	referencias
anhang	anexo
anhang	adjunto
schulden	deuda
barth	barth
naturforscher	naturalista
nebel	niebla
carmen	carmen
ffffff	ffffff
codex	codex
kommunalen	comunal
turniere	torneos
überlebenden	sobrevivientes
überlebenden	supervivientes
león	león
caesar	césar
gerichtsbarkeit	jurisdicción
hedwig	hedwig
trennte	separó
susan	susan
exemplar	espécimen
unrecht	injusticia
analysen	análisis
treppe	escaleras
treppe	escalera
diplomatischen	diplomático
winterthur	winterthur
oberpfalz	oberpfalz
holmes	holmes
dramatiker	dramaturgo
ware	mercancía
antisemitismus	antisemitismo
restaurants	restaurantes
kantone	cantones
heck	heck
hardware	hardware
stolz	orgullo
schicken	enviar
leverkusen	leverkusen
göttin	diosa
electric	electric
mittelfeld	mediocampo
stärken	fortalezas
vereint	unida
vereint	unidos
barocken	barroco
schweigen	silencio
elektronik	electrónica
revision	revisión
helga	helga
instanz	instancia
geologe	geólogo
witz	broma
munition	munición
aschaffenburg	aschaffenburg
vegas	vegas
neil	neil
kramer	kramer
utah	utah
celle	celle
trek	trek
flüssen	ríos
brett	tablero
brett	brett
slowakischen	eslovaco
unterhaltung	entretenimiento
festgenommen	arrestado
zukünftige	futuros
zukünftige	futura
zukünftige	futuras
allan	allan
gutenberg	gutenberg
kosmos	cosmos
kontinent	continente
konstruiert	construido
beachtet	notado
zeitgenossen	contemporáneos
castro	castro
götz	götz
happy	happy
föderation	federación
reg	reg
haas	haas
symptome	síntomas
fluggesellschaft	aerolínea
hopkins	hopkins
unwahrscheinlich	improbable
jahn	jahn
nfl	nfl
species	species
rohr	tubo
danny	danny
maier	maier
dean	dean
ringe	anillos
neutrale	neutral
liberale	liberal
liberale	liberales
children	children
sort	sort
ausgedrückt	expresadas
ausgedrückt	expresada
ausgedrückt	expresado
gross	grande
längengrad	longitud
albanien	albania
angreifer	agresor
angreifer	atacante
valencia	valencia
unterzeichnet	firmado
alexandre	alexandre
vertreibung	expulsión
toni	toni
emden	emden
schlachten	batallas
mediale	medial
marmor	mármol
kant	kant
katze	gato
brd	rfa
judith	judith
erweiterungen	extensiones
adalbert	adalbert
sternbild	constelación
bedeutungen	significados
lok	lok
justus	justus
angriffen	ataques
monster	monstruos
monster	monstruo
landau	landau
statistiken	estadísticas
works	works
pos	pos
sorten	variedades
liberal	liberal
liberal	liberales
march	march
paula	paula
alb	alb
cape	cape
hampshire	hampshire
landen	aterrizar
stanford	stanford
imdb	imdb
fußballer	futbolistas
fußballer	futbolista
rudi	rudi
record	record
konservative	conservadores
konservative	conservador
ludwigshafen	ludwigshafen
limited	limited
höhlen	cuevas
umbauten	etiquetas
äthiopien	etiopía
birmingham	birmingham
anfragen	consultas
kopieren	copiar
kopieren	copia
waldemar	waldemar
hob	recogió
hob	levantó
gestanden	confesó
gestanden	confesado
alba	alba
verstärkte	reforzado
zucker	azúcar
ida	ida
winfried	winfried
anregung	sugerencia
byzantinischen	bizantino
singt	canten
singt	canta
beliebig	opcionalmente
beliebig	arbitrario
fertigung	fabricación
erlassen	adoptarán
gisela	gisela
short	short
sigmund	sigmund
gelebt	vivido
société	société
haare	cabello
haare	pelo
battle	battle
budget	presupuesto
nicole	nicole
transkription	transcripción
lucius	lucio
abzug	deducción
verziert	adornado
circle	circle
präsentation	presentación
einigung	acuerdo
zwickau	zwickau
getreide	cereales
sigismund	sigismund
fpö	fpö
sozialismus	socialismo
temple	temple
doris	doris
fehlte	faltaba
treffern	hits
perspektiven	perspectivas
madison	madison
magic	magic
respekt	respeto
zentren	centros
tambon	tambon
büros	oficinas
deportiert	deportados
deportiert	deportado
kommerziell	comercial
überschritten	excedido
überschritten	superado
repertoire	repertorio
protestantischen	protestantes
protestantischen	protestante
angekommen	llegado
joint	joint
oma	abuela
only	only
audi	audi
tipp	sugerencia
tödlich	mortal
geworfen	lanzados
geworfen	lanzada
geworfen	tirado
geworfen	lanzado
zufrieden	contento
zufrieden	satisfecho
widerspricht	contradice
veraltet	obsoleto
bozen	bolzano
eroberte	conquistó
butler	butler
butler	mayordomo
knight	knight
ethnien	etnias
vegetation	vegetación
gehirn	cerebro
born	born
säule	pilar
säule	columna
empfehlen	recomendamos
empfehlen	recomendar
armstrong	armstrong
into	into
isaac	isaac
ludwigsburg	ludwigsburg
humor	humor
fazit	conclusión
meiningen	meiningen
montiert	montada
montiert	montado
emmy	emmy
hannes	hannes
engländer	inglés
kessel	calderas
kessel	caldera
kessel	caldero
messer	cuchillos
messer	cuchillo
brt	trb
legion	legión
ergo	ergo
aristoteles	aristóteles
gladbach	gladbach
expansion	expansión
sakristei	sacristía
side	side
schlag	golpe
konzentrieren	concentrarse
konzentrieren	concentrar
industrialisierung	industrialización
igor	igor
erheben	alzar
vernunft	razón
freising	freising
zensur	censura
nachteile	desventajas
dreieck	triángulo
intelligenz	inteligencia
pol	pol
entkommen	escapar
senkrecht	verticalmente
senkrecht	vertical
mediawiki	mediawiki
gekürzt	recortado
experte	experto
aufgerufen	llamada
augusta	augusta
warte	espera
skandal	escándalo
publications	publications
bauch	abdomen
bauch	vientre
bauch	estómago
fördert	fomenta
fördert	promueve
logos	logos
logos	logotipos
mächtigen	poderosos
blockiert	bloqueado
bankier	banquero
low	low
seattle	seattle
grundsatz	principio
fünfter	quinto
fünfter	quinta
fächer	abanico
fächer	materias
apsis	ábside
bio	bio
begeistert	emocionado
begeistert	entusiasta
theologen	teólogos
arbeitnehmer	trabajadores
watson	watson
iris	iris
burgenland	burgenland
quedlinburg	quedlinburg
wiese	prado
wiese	pradera
seltsam	extraño
überzeugung	convicción
überzeugung	persuasión
gasse	callejón
bergisch	bergisch
amtliche	oficiales
treu	fieles
treu	fiel
nachdenken	reflexionar
nachdenken	reflexiona
nachdenken	pensar
kunststoff	plástico
angebliche	supuesta
folk	folk
bestandteile	ingredientes
bestandteile	componentes
handschriften	manuscritos
erwartungen	expectativas
werkzeug	herramienta
tauchen	buceo
ibm	ibm
sophia	sophia
unvollständig	incompleta
unvollständig	incompleto
umstellung	reconversión
georgien	georgia
zerstören	destruir
professorin	profesora
ausgenommen	excepto
gedächtnis	memoria
spitznamen	apodo
spitznamen	apodos
illustrator	ilustrador
anschlag	atentado
heimlich	secreto
saar	sarre
verletzte	heridos
wertvolle	valiosos
wertvolle	valioso
wertvolle	valiosa
tempo	ritmo
tempo	tempo
reinhardt	reinhardt
parallelen	paralelo
klubs	clubs
klubs	clubes
square	square
getestet	probado
cousin	primo
geistes	espíritu
ungültig	inválido
queensland	queensland
moser	moser
dietz	dietz
optisch	óptico
optisch	visualmente
jeanne	juana
jeanne	jeanne
herzegowina	herzegovina
secret	secret
hinzufügen	agregar
hinzufügen	añadir
trade	trade
statuen	estatuas
experimente	experimentos
verehrt	adora
armut	pobreza
libanon	líbano
flog	voló
fine	bellas
lieutenant	teniente
unbrauchbar	inútil
protein	proteína
organe	órganos
organisieren	organizar
dänisch	danés
vorwärts	adelante
ausgetauscht	intercambiado
betrag	monto
betrag	importe
mathilde	mathilde
jugendlicher	adolescente
freiberg	freiberg
blind	blind
apostolische	apostólica
publishers	publishers
césar	césar
mohr	mohr
böhlau	böhlau
beamte	funcionarios
gonzález	gonzález
israelische	israelí
leidenschaft	pasión
artist	artist
glockenturm	campanario
vereinbarung	acuerdo
thriller	thriller
regierte	gobernó
gitarristen	guitarrista
sachverhalt	hechos
dokumenten	documentos
zusammenstellung	compilación
eifel	eifel
kostete	costó
amadeus	amadeus
verhältnismäßig	proporcional
verhältnismäßig	relativamente
verhältnismäßig	proporcionado
tell	tell
opel	opel
linda	linda
rita	rita
angelo	angelo
martina	martina
aue	aue
brechen	rompiendo
brechen	romper
isabella	isabella
ville	ville
arnsberg	arnsberg
künstliche	artificial
motorsport	motorsport
gesetzlich	legalmente
trust	trust
trust	fiduciario
pays	pays
müll	basura
honda	honda
palermo	palermo
handwerker	artesanos
verwandtschaft	parentesco
verwandtschaft	relación
beute	botín
kompromiss	compromiso
elektrisch	eléctrico
münze	moneda
veranstalter	organizador
rechtschreibung	ortografía
panorama	panorama
professionelle	profesional
professionelle	profesionales
moral	moralidad
moral	moral
tallinn	tallin
never	never
judentum	judaísmo
romeo	romeo
kasachstan	kazajistán
kasachstan	kazajstán
brannte	ardía
verkörperte	encarnó
vollzogen	consumado
nils	nils
scottish	scottish
überlebt	sobrevive
überlebt	sobrevivido
märtyrer	mártir
märtyrer	mártires
explosion	explosión
geschäftsmann	empresario
theoretischen	teórico
larven	larvas
rangers	rangers
contemporary	contemporary
drogen	drogas
arabisch	árabe
bautzen	bautzen
präsenz	presencia
terror	terror
rhône	ródano
soziologe	sociólogo
tibet	tíbet
tibet	tibet
sparen	ahorrar
sparen	ahorro
homo	homo
territorien	territorios
nacheinander	sucesivamente
booten	arrancar
booten	arranque
ökonomie	economía
ewald	ewald
jefferson	jefferson
algebra	álgebra
pascal	pascal
homosexualität	homosexualidad
formale	formales
formale	formal
zeuge	testigo
hope	hope
billboard	billboard
militärisch	militares
militärisch	militar
bowl	bowl
edwards	edwards
aufträge	encargos
aufträge	contratos
oberseite	tapa
opfern	víctimas
jenny	jenny
sevilla	sevilla
birgit	birgit
korrektur	corrección
entdecker	explorador
holt	holt
telekom	telekom
wöchentlich	semanal
wöchentlich	semanales
ideal	ideal
communes	communes
erzeugung	generación
erzeugung	producción
tff	tff
künstlich	artificial
spencer	spencer
hardy	hardy
unsicher	inseguro
äbtissin	abadesa
angestellte	empleados
ram	ram
kleve	cléveris
verkürzt	acorta
olivier	olivier
schmuck	joyería
schmuck	joyas
innovation	innovación
werder	werder
öffnet	abre
craig	craig
zivilen	civil
sammelt	recoge
musikalisch	musical
dumont	dumont
boten	mensajeros
boten	mensajero
flüssigkeit	líquido
altona	altona
steinbruch	cantera
privater	privado
mähren	moravia
häfen	puertos
entschuldigung	disculpa
editor	editor
anhängern	remolques
alessandro	alessandro
mix	mix
gfdl	gfdl
aka	alias
aka	aka
umfrage	encuesta
else	else
werkzeuge	herramientas
jennifer	jennifer
schilling	chelines
schilling	chelín
bemerkung	observación
aufgewachsen	creció
aufgewachsen	criado
harte	duro
harte	duros
allgäu	allgäu
sandra	sandra
rezensionen	repaso
rezensionen	reseñas
cannes	cannes
tänzerin	bailarina
anklage	cargos
anklage	acusación
betroffene	afectado
brauche	necesito
weiden	pastos
lettland	letonia
sammler	coleccionistas
sammler	coleccionista
aktualisiert	actualizado
aktualisiert	actualización
etappen	etapas
apollo	apolo
sudan	sudán
stimmte	votó
bewerten	calificar
bewerten	evaluar
mut	coraje
mut	valentía
mut	valor
achsen	ejes
crew	tripulación
crew	crew
enterprise	enterprise
stützen	soportes
stützen	apoyar
lüttich	lieja
algorithmus	algoritmo
einhaltung	cumplimiento
étienne	étienne
cars	cars
watt	watt
watt	vatios
balthasar	baltasar
reis	arroz
bär	oso
slam	slam
gert	gert
zielen	apuntar
ecuador	ecuador
potential	potencial
ilse	ilse
haar	cabello
haar	pelo
rosenheim	rosenheim
trinken	beber
support	soporte
nachhaltig	sostenible
potter	potter
kategorisiert	categorizados
pazifik	pacífico
duell	duelo
limes	limes
verschwindet	desaparece
verringert	reduce
verringert	reducido
verringert	disminuye
zahlung	pago
third	third
bergmann	minero
nathan	nathan
ausländer	extranjeros
ausländer	extranjero
spitz	spitz
guatemala	guatemala
portland	portland
spam	spam
annette	annette
introduction	introduction
anschließen	conectar
geliebte	amante
geliebte	amantes
aufkommen	advenimiento
optische	óptica
optische	óptico
geschützten	protegidas
willem	willem
leonardo	leonardo
flash	flash
fonds	fondos
fonds	fondo
havel	havel
verbringen	pasar
etablierten	establecida
#default	#default
verdienen	ganar
view	view
ausser	excepto
intensive	intensa
intensive	intensivo
intensive	intenso
locker	suelto
locker	flojo
messungen	medición
messungen	mediciones
vergabe	adjudicación
seven	seven
komm	ven
risiken	riesgos
wettkampf	competición
markgrafen	margrave
herzöge	duques
konzeption	concepción
beleidigung	insulto
beleidigung	insultos
differenzen	diferencias
simone	simone
championships	championships
besuchten	visitaron
verschwand	desapareció
datierung	datación
inter	inter
braunschweiger	braunschweiger
fühlen	sensación
fühlen	sentir
bratislava	bratislava
nächstes	siguiente
potok	potok
ming	ming
grace	grace
elektronen	electrones
klassisch	clásica
klassisch	clásico
mosel	mosela
vereinbart	acordado
vereinbart	convenido
stuhl	silla
neffen	sobrinos
neffen	sobrino
zustände	estados
beweise	pruebas
neuhaus	neuhaus
magister	magistrado
republikaner	republicanos
republikaner	republicano
grabmal	tumba
nachwuchs	descendencia
laufzeit	duración
minderheiten	minorías
einschränkungen	limitaciones
einschränkungen	restricciones
some	some
biologische	biológica
nützlich	útil
nützlich	útiles
wiedergewählt	reelegido
druckerei	imprenta
lambert	lambert
lima	lima
dog	dog
buchhandlung	librería
modernisierung	modernización
angeklagt	acusado
vermont	vermont
schädel	cráneo
toyota	toyota
willkürlich	arbitraria
willkürlich	arbitrario
stiftungen	fundaciones
schuster	zapatero
nepomuk	nepomuk
dec	dec
formulieren	formular
formulieren	formule
beschreibungen	descripciones
mbh	mbh
television	television
thesen	tesis
münden	desembocar
kate	kate
hanna	hanna
hervorgehoben	subrayado
hervorgehoben	destacado
gregory	gregory
return	return
balken	vigas
balken	viga
cia	cia
taufe	bautismo
kompetenz	competencia
fordern	exigimos
fordern	exigir
eingliederung	integración
eingliederung	inserción
race	race
kay	kay
chur	chur
schmitz	schmitz
socke	calcetín
pittsburgh	pittsburgh
prosa	prosa
bosch	bosch
romantik	romance
signale	señales
irish	irish
mechanik	mecánica
schenk	schenk
karosserie	carrocería
sigmaringen	sigmaringen
unterbrechung	interrupción
nachname	apellido
ewig	eterno
ewig	eternos
pädagogische	pedagógica
geladen	cargada
geladen	cargando
geladen	cargado
romanen	novelas
here	here
manuskript	manuscrito
fasst	resume
landgraf	landgraf
scheiterten	fracasaron
pölten	pölten
plastik	plásticos
plastik	plástico
lehnt	rechaza
ausbreitung	propagación
montevideo	montevideo
neuss	neuss
beta	beta
beschränken	limitar
beschränken	restringir
tunesien	túnez
hintergründe	antecedentes
diagnose	diagnosis
diagnose	diagnóstico
verstärkung	refuerzo
verstärkung	amplificación
justin	justin
zurückziehen	retirada
zurückziehen	retirarse
zurückziehen	retirar
transformation	transformación
ingo	ingo
rebellen	rebeldes
saur	saur
konzil	concilio
tochtergesellschaft	filial
tochtergesellschaft	filiales
vorbehalten	reservados
vorbehalten	reservado
großmutter	abuela
maurer	albañil
extreme	extrema
extreme	extreme
ostern	pascua
saga	saga
ravensburg	ravensburg
irgendein	cualquiera
schienen	rieles
schienen	carriles
terminal	terminal
fähig	capaz
trend	tendencias
trend	tendencia
währung	moneda
umgestaltung	remodelado
umgestaltung	rediseño
telefon	teléfono
ligen	ligas
colonel	coronel
feinde	enemigos
fiat	fiat
fragmente	fragmentos
opus	opus
zwangsläufig	necesariamente
zwangsläufig	inevitablemente
nordwest	noroeste
weiterentwickelt	evolucionado
klinische	clínica
hong	hong
kostet	cuesta
