von	di
von	da
des	del
mit	con
für	per
ein	un
auch	anche
sich	si
nicht	non
nach	dopo
war	war
war	era
bis	fino
ich	io
werden	diventare
sind	sono
oder	oppure
wird	sarà
wird	diventa
durch	attraverso
cet	cet
aber	ma
wie	come
nur	solo
noch	ancora
unter	sotto
hat	ha
hat	hat
artikel	articolo
man	man
vor	prima
sein	essere
diese	questo
diese	questi
the	the
vom	dal
kann	può
hier	qui
diskussion	discussione
jahr	anno
wenn	quando
wenn	se
dann	allora
dann	poi
zwei	due
jahre	anni
mai	maggio
isbn	isbn
hatte	avuto
hatte	aveva
zwischen	tra
zwischen	fra
team	squadra
mehr	più
gegen	contro
keine	nessuna
waren	merci
stadt	città
haben	avere
gibt	restituisce
mal	volta
mal	volte
ersten	primi
ersten	primo
jedoch	tuttavia
dort	lì
dort	là
seed	seed
drei	tre
teil	porzione
berlin	berlino
heute	oggi
alle	tutti
während	mentre
bereits	già
dieses	questo
jan	jan
sehr	molto
erste	prima
august	agosto
ohne	senza
sollte	dovrebbe
deutschland	germania
ihm	dargli
ende	fine
märz	marzo
deutsche	tedeschi
band	nastro
januar	gennaio
doch	eppure
oktober	ottobre
immer	sempre
also	quindi
wikipedia	wikipedia
jun	jun
kirche	chiesa
juni	giugno
konnte	poteva
konnte	potuto
april	aprile
september	settembre
selbst	stesso
juli	luglio
andere	altri
geschichte	storia
apr	apr
jpg	jpg
dezember	dicembre
dez	dic
universität	università
sep	sep
november	novembre
liste	lista
kam	arrivò
wir	noi
jahrhundert	secolo
vier	quattro
seite	pagina
februar	febbraio
etwas	qualcosa
mich	me
zusammen	insieme
neben	accanto
film	film
wäre	sarebbe
nun	nun
leben	vita
new	new
namen	nomi
bitte	prego
relevanz	pertinenza
muss	deve
einige	alcuni
mitglied	membro
viele	molti
text	testo
münchen	monaco
löschen	elimina
löschen	eliminare
bekannt	conosciuto
zurück	indietro
ort	luogo
ort	località
geht	va
geht	andate
jetzt	adesso
jetzt	ora
friedrich	friedrich
stand	stand
würde	dignità
titel	titolo
karl	karl
gut	bene
gut	buono
statt	invece
daher	pertanto
familie	famiglia
weiter	avanti
sohn	figlio
außerdem	inoltre
hans	hans
johann	johann
erl	erl
gehört	appartiene
bild	immagine
nichts	nulla
nichts	niente
wien	vienna
gelöscht	eliminato
kommt	arriva
menschen	persone
sei	sii
fall	caduta
wilhelm	guglielmo
wilhelm	wilhelm
englisch	inglese
fünf	cinque
könig	re
besteht	insiste
welche	quali
welche	quale
form	forma
meter	metri
schloss	castello
gruppe	gruppo
finden	trovare
spielte	giocato
neu	nuovo
john	john
könnte	potrebbe
beispiel	esempio
usa	usa
recht	diritto
bin	bin
york	york
paul	paul
frage	domanda
insgesamt	totale
gehörte	apparteneva
eher	piuttosto
unternehmen	società
unternehmen	azienda
straße	strada
rund	rotondo
einfach	facile
einfach	semplice
schließlich	infine
datei	file
frau	donna
land	paese
fast	quasi
hatten	avuti
hatten	avevano
tod	morte
arbeit	lavoro
macht	potere
vielleicht	forse
vielleicht	magari
paris	parigi
alles	tutto
landkreis	circondario
kategorie	categoria
bedeutung	significato
relevant	pertinente
bereich	settore
welt	mondo
verein	randello
anfang	inizio
quelle	fonte
quelle	sorgente
michael	michael
region	regione
allen	allen
hamburg	amburgo
besonders	specialmente
besonders	particolarmente
deutsch	tedesco
franz	franz
lange	lungo
gegründet	fondato
gegründet	fondata
website	sito
folge	segui
beide	entrambi
beide	entrambe
will	will
georg	georg
arbeitete	lavorato
einwohner	abitanti
innerhalb	entro
führt	conduce
london	londra
alten	vecchi
kinder	bambini
österreich	austria
weg	sentiero
regie	regia
album	album
museum	museo
gebäude	edifici
wenig	poco
kreis	cerchio
frankreich	francia
pro	pro
thomas	thomas
grund	ragione
grund	motivo
möglich	possibile
thema	tema
rolle	ruolo
rolle	rotolo
handelt	agisce
gewünscht	desiderato
entwicklung	sviluppo
bau	costruzione
zweite	seconda
frankfurt	francoforte
stuttgart	stoccarda
benutzer	utenti
maria	maria
vater	padre
vater	papà
frauen	donne
buch	libro
provinz	provincia
quellen	fonti
bleibt	resta
kilometer	chilometro
stunden	ore
martin	martin
schule	scuola
leipzig	lipsia
https	https
ludwig	ludwig
jeder	ogni
archivierung	archiviazione
dorf	villaggio
robert	robert
tochter	figlia
stark	forte
gewählt	eletto
oben	sopra
mann	uomo
spielen	giocare
iii	iii
weiß	bianco
bar	bar
amt	amt
sogar	persino
seiten	pagine
richtung	direzione
köln	colonia
partei	partito
wer	chi
http	http
version	versione
international	international
tage	giorni
rahmen	cornice
werke	opere
offizielle	ufficiale
kommen	venire
weniger	meno
deshalb	pertanto
autor	autore
fußballspieler	calciatore
wirklich	veramente
wirklich	davvero
preis	prezzo
ddr	ddr
genau	proprio
genau	esattamente
genau	esatto
spiel	gioco
for	for
teilweise	parzialmente
schweiz	svizzera
serie	serie
verschiedene	vari
natürlich	naturalmente
natürlich	ovviamente
jemand	qualcuno
arbeiten	lavorare
tag	giorno
norden	nord
sollten	dovrebbero
literatur	letteratura
millionen	milioni
krieg	guerra
besser	meglio
sprache	lingua
lemma	lemma
danke	grazie
kunst	arte
schauspieler	attore
auflage	tiratura
style	style
auswahl	selezione
spieler	giocatore
links	sinistra
warum	perché
otto	otto
from	from
bisher	finora
beschreibung	descrizione
online	online
direkt	direttamente
schriftsteller	scrittore
alter	età
klasse	classe
obwohl	sebbene
gemeinden	comuni
bischof	vescovo
erschien	apparve
professor	professore
höhe	altezza
reihe	fila
süden	sud
entfernt	rimosso
gehören	appartenendo
gehören	appartengono
ließ	lasciava
christian	christian
johannes	giovanni
erwähnt	menzionato
erwähnt	accennato
chr	chr
informationen	informazioni
bezeichnung	denominazione
saint	saint
meister	maestro
meister	padrone
sicher	sicuro
insel	isola
klar	chiaro
joseph	joseph
veröffentlicht	pubblicato
ursprünglich	originariamente
carl	carl
sieben	sette
bevölkerung	popolazione
osten	est
van	van
gleich	uguale
alte	vecchia
internationalen	internazionale
problem	problema
bayern	baviera
westen	ovest
mitglieder	membri
hinter	dietro
graf	conte
david	davide
baden	baden
kaiser	imperatore
nie	mai
arten	specie
geboren	nato
richard	richard
richard	riccardo
sitz	sedile
wasser	acqua
hermann	hermann
san	san
karriere	carriera
zehn	dieci
system	sistema
bilder	immagini
erreicht	raggiunta
erreicht	raggiunto
enthält	contiene
beitrag	contributo
main	main
mutter	madre
mutter	mamma
linie	linea
bahnhof	stazione
west	west
weit	lontano
ziel	obiettivo
roman	roman
roman	romanzo
liga	lega
liga	liga
spiele	giochi
sachsen	sassonia
wolfgang	wolfgang
folgen	seguire
walter	walter
leider	purtroppo
uhr	orologio
liegen	lettini
geben	dare
geben	digitare
kultur	cultura
hab	abbi
trotz	nonostante
genutzt	sfruttato
projekt	progetto
maler	pittore
paar	coppia
max	max
sommer	estate
william	william
institut	istituto
raum	spazio
armee	esercito
jean	jean
tun	fare
gleichzeitig	simultaneamente
vereinigten	unito
regel	regola
gefunden	trovato
welches	quale
theater	teatro
wollte	voleva
person	persona
mein	mio
kloster	monastero
com	com
hilfe	aiuto
reich	ricco
zumindest	almeno
dich	te
dich	ti
schnell	veloce
einzelnen	singolo
teile	parti
world	world
gmbh	gmbh
gmbh	srl
google	google
besten	migliori
republik	repubblica
italien	italia
fragen	domande
hälfte	metà
euro	euro
verbindung	connessione
nähe	vicinanza
anders	anders
vertrag	trattato
vertrag	contratto
sonst	altrimenti
james	james
top	top
bruder	fratello
künstler	artista
england	inghilterra
erfolg	successo
früher	precedentemente
wissen	sapere
wissen	conoscenza
länge	lunghezza
groß	grande
ganze	interi
geschrieben	scritto
abschnitt	sezione
rechts	destra
trainer	allenatore
gerne	volentieri
see	lago
hohen	alto
hohen	sommo
etc	etc
ausbildung	formazione
park	parco
george	george
wappen	stemma
zürich	zurigo
wort	parola
komponist	compositore
zahl	numero
dresden	dresda
schreiben	scrittura
rudolf	rudolf
nahe	vicino
league	league
tore	cancelli
wahl	scelta
männer	uomini
schauspielerin	attrice
wiener	wiener
hannover	hannover
beste	migliore
zeitung	quotidiano
spd	spd
schlacht	battaglia
richtig	giusto
akademie	accademia
gehen	camminare
stil	stile
sagen	dire
charles	charles
american	american
funktion	funzione
wahrscheinlich	probabilmente
wahrscheinlich	probabile
erreichen	raggiungere
till	till
herzog	duca
liebe	amore
rom	roma
umfasst	comprende
nachfolger	successore
grenze	confine
nächsten	prossimi
truppen	truppe
britischen	britannico
werner	werner
verwendung	uso
sieg	vittoria
entwickelt	sviluppato
china	cina
falls	falls
besitzt	possiede
leicht	leggero
leicht	leggermente
besitz	possesso
verbunden	collegato
bald	presto
autoren	autori
all	all
tiefe	profondità
press	press
bürgermeister	sindaco
polen	polonia
link	link
verheiratet	sposato
ernannt	nominato
km²	km²
produktion	produzione
berg	montagna
sla	sla
alt	vecchio
punkt	punto
andreas	andreas
stiftung	fondazione
aktiv	attivo
aktiv	attiva
gute	buona
punkte	punti
sinne	sensi
gegensatz	contrapposizione
minuten	minuti
bleiben	rimanere
frühen	precoce
her	her
rang	rango
historischen	storico
ähnlich	simile
finale	finale
verfahren	procedura
tour	tour
wollen	volere
ergebnis	risultato
mark	mark
württemberg	württemberg
falsch	sbagliato
gold	oro
weise	saggio
außer	tranne
außer	salvo
heiligen	santi
möglichkeit	possibilità
ausgabe	edizione
river	river
rennen	corsa
union	unione
japan	giappone
müller	müller
albert	albert
kanton	cantone
düsseldorf	düsseldorf
versucht	tentato
erkennen	riconoscere
politik	politica
anna	anna
katholischen	cattolica
right	right
position	posizione
ausschließlich	esclusivamente
gruppen	gruppi
weder	nè
weder	né
satz	frase
satz	teorema
öffentlichen	pubblico
ersetzt	sostituito
hauptsächlich	principalmente
derzeit	attualmente
indem	eliminando
indem	mettendo
stimmen	voci
stimmen	voti
geführt	condotto
engl	engl
wert	valore
frei	libero
frank	frank
klaus	klaus
kritik	critica
inhalt	contenuto
heinz	heinz
bekannte	conoscenti
beteiligt	partecipa
beteiligt	implicato
beteiligt	coinvolta
wochen	settimane
fritz	fritz
kategorien	categorie
louis	louis
records	records
selten	rari
dritte	terza
fluss	fiume
admin	admin
club	club
bremen	brema
relativ	relativamente
erklärt	spiegato
fort	acceso
musiker	musicisti
gesehen	visto
nimmt	prende
nimmt	toglie
adolf	adolf
schiff	nave
fußball	calcio
bedeutet	significa
bietet	offre
vertreter	rappresentante
hochgeladen	caricato
hessen	assia
organisation	organizzazione
les	les
leute	gente
halten	mantenere
halten	tenere
hand	mano
sammlung	collezione
lexikon	lessico
www	www
unterstützung	supporto
meisterschaft	campionato
erbaut	costruito
sinn	senso
westfalen	vestfalia
bezirk	distretto
hoch	alto
außerhalb	fuori
herren	signori
karte	mappa
probleme	problemi
alfred	alfred
erscheint	compare
orte	luoghi
hallo	ciao
trotzdem	ciononostante
vergleich	confronto
php	php
halle	halle
langen	langen
anton	anton
neun	nove
genommen	preso
wirtschaft	economia
college	college
brachte	portò
markt	mercato
kapelle	cappella
verloren	perso
ausgezeichnet	eccellente
russland	russia
trägt	indossa
bonn	bonn
jugend	gioventù
allgemeinen	generale
spanien	spagna
post	post
soldaten	soldati
lebt	vive
tätigkeit	attività
zeigen	mostrare
sinnvoll	sensato
umgebung	dintorni
bücher	libri
medien	media
entscheidung	decisione
einfluss	influenza
monate	mesi
anlage	appendice
beschrieben	descritto
schutz	protezione
lied	canzone
geworden	diventato
nämlich	infatti
cdu	cdu
rechte	diritti
color	color
erkennbar	riconoscibile
stück	pezzo
programm	programma
live	live
jazz	jazz
unten	giù
papst	papa
themen	temi
gerhard	gerhard
regelmäßig	regolarmente
junge	ragazzo
eltern	genitori
sprachen	lingue
internet	internet
ländern	paesi
größe	taglia
größe	dimensioni
start	start
start	lancio
spricht	parla
hauptstadt	capitale
regisseur	regista
abschluss	completamento
philosophie	filosofia
friedhof	cimitero
lehrer	insegnante
würden	sarebbero
betrug	frode
kopf	testa
zusammenarbeit	cooperazione
nein	no
gebracht	portato
brücke	ponte
überwiegend	prevalentemente
zerstört	distrutta
zerstört	distrutto
bundesliga	bundesliga
teilen	condividi
nacht	notte
versionen	versioni
lesen	leggere
daniel	daniel
idee	idea
rot	rosso
eindeutig	chiaramente
turm	torre
lebte	vissuto
klein	piccolo
interesse	interesse
genug	abbastanza
zuerst	prima
enzyklopädie	enciclopedia
mussten	dovevano
kind	bambino
münster	münster
svg	svg
studien	studi
direktor	direttore
ost	ost
marie	marie
gustav	gustav
freiburg	friburgo
fehlt	manca
fehlt	mancante
modell	modello
bildung	istruzione
washington	washington
kurze	breve
gesagt	detto
you	you
kampf	combattimento
vertreten	rappresentare
abteilung	divisione
beginnt	inizia
bringen	portare
schwarz	nero
with	with
ulrich	ulrich
kurt	kurt
regeln	regole
wald	foresta
ferdinand	ferdinand
joachim	joachim
erfolge	successi
löschung	cancellazione
dollar	dollaro
music	music
besondere	speciale
jürgen	jürgen
sänger	cantanti
heidelberg	heidelberg
weitgehend	largamente
weitgehend	estesamente
fischer	pescatore
fischer	pescatori
schweden	svezia
ergebnisse	risultati
verkauft	venduto
vandalismus	vandalismo
zwölf	dodici
gelten	valgono
juden	ebrei
border	border
henry	henry
elisabeth	elisabetta
möglicherweise	possibilmente
brandenburg	brandeburgo
anschluss	connettore
suche	ricerca
breite	larghezza
royal	royal
festival	festival
übersetzung	traduzione
versuch	tentativo
folgten	seguirono
pfalz	palatinato
beziehungen	relazioni
rhein	reno
bewegung	movimento
opfer	sacrificio
opfer	vittime
bayerischen	bavarese
erde	terra
angegeben	specificato
technik	tecnica
united	united
technischen	tecnico
mag	mag
open	open
mainz	mainz
boden	terreno
boden	suolo
grand	grand
grundlage	fondamento
radio	radio
entdeckt	scoperto
bernhard	bernhard
erzbischof	arcivescovo
halt	ferma
ungarn	ungheria
stammen	provenire
verbreitet	diffuso
bezug	riferimento
pierre	pierre
software	software
rock	rock
entsprechenden	corrispondente
aufstieg	salita
verwaltung	amministrazione
wiki	wiki
bank	banca
rein	entrare
mannschaften	squadre
tor	tor
herbst	autunno
schulen	scuole
schmidt	schmidt
gehörten	appartenevano
essen	mangiare
göttingen	gottinga
richter	giudice
ausstellung	mostra
ausstellung	esposizione
aufgabe	compito
geld	denaro
geld	soldi
kirchen	chiese
lösung	soluzione
north	north
tiere	animali
rheinland	renania
werbung	pubblicità
winter	inverno
unterschied	differenza
familien	famiglie
inseln	isole
offensichtlich	ovvio
objekte	oggetti
society	society
house	house
nürnberg	norimberga
blick	sguardo
silber	argento
hintergrund	sfondo
französisch	francese
theorie	teoria
air	air
erweitert	avanzate
manchmal	talvolta
wuchs	cresciuto
verlauf	cronologia
laufe	corso
treffen	incontri
arbeitet	lavora
architekt	architetto
jurist	giurista
fällt	cade
zählt	conta
eingeführt	introdotto
hält	mantiene
nördlichen	settentrionale
south	south
existiert	esiste
führung	leadership
bestimmte	determinate
bestimmte	determinati
ordnung	ordine
tragen	indossare
fällen	casi
herbert	herbert
star	star
wichtigsten	principali
westlichen	occidentali
linken	sinistro
zeichen	caratteri
früheren	precedente
kraft	forza
braunschweig	braunschweig
verhalten	comportamento
herkunft	provenienza
sport	sport
geprägt	coniato
mittel	stanziamenti
mittel	mezzi
verbreitung	diffusione
verbreitung	divulgazione
sofort	immediatamente
sofort	subito
wissenschaft	scienza
gesetz	legge
journalist	giornalista
moskau	mosca
hamburger	hamburger
edit	edit
stimme	voce
qualität	qualità
veröffentlichung	pubblicazione
zahlen	numeri
galerie	galleria
verlassen	abbandonato
black	black
aufgaben	compiti
title	title
fehler	errore
filme	pellicole
stadion	stadio
moderne	moderne
basel	basilea
org	org
sur	sur
wagen	carro
situation	situazione
wichtig	importante
leistung	potenza
handbuch	manuale
gespielt	giocato
motor	motore
offiziell	ufficialmente
dieter	dieter
texte	testi
gott	dio
rat	consiglio
gesetzt	impostato
villa	villa
dichter	poeta
helmut	helmut
nationalen	nazionale
beschäftigt	occupato
hergestellt	fabbricato
tal	valle
fotos	foto
sagt	dice
gewinnen	vincere
woche	settimana
schreibt	scrive
information	informazione
erich	erich
fernsehen	televisione
schleswig	schleswig
stein	pietra
sah	guardato
preußen	prussia
nennt	chiama
wären	sarebbero
natur	natura
gleichnamigen	omonimo
dienen	servire
weist	assegna
kosten	costi
kosten	costo
teilnehmer	partecipanti
archiv	archivio
chor	coro
stefan	stefan
bach	bach
polizei	polizia
jakob	jakob
schön	belli
html	html
super	super
australien	australia
left	left
hall	hall
zeiten	orari
kreuz	croce
png	png
niemand	nessuno
zukunft	futuro
änderungen	modifiche
bern	berna
revolution	rivoluzione
tradition	tradizione
kanada	canada
veröffentlichungen	pubblicazioni
straßen	strade
architektur	architettura
umbenannt	rinominato
arzt	medico
parallel	parallelo
parallel	parallela
mittelalter	medioevo
medizin	medicina
praxis	pratica
zählen	contare
rest	resto
bibliothek	biblioteca
konrad	konrad
freund	amico
antwort	risposta
geschlossen	chiuso
love	love
landwirtschaft	agricoltura
könnten	potrebbero
weißen	bianchi
auflösung	risoluzione
salzburg	salisburgo
tritt	entra
erscheinen	apparire
wissenschaftlichen	scientifico
übertragen	trasferito
fahrzeuge	veicoli
portal	portale
erstellt	creato
schiffe	navi
schwester	sorella
augen	occhi
min	min
beispiele	esempi
gezeigt	mostrato
theologe	teologo
wirkung	effetto
notwendig	necessario
aufgeführt	elencato
simon	simon
don	don
präsidenten	presidenti
julius	julius
anwendung	applicazione
lieber	caro
lake	lake
formel	formula
santa	santa
red	red
geburtstag	compleanno
regiment	reggimento
dein	tuo
niederlage	sconfitta
chicago	chicago
sankt	sankt
formen	stampi
orgel	organo
wolf	lupo
elf	undici
elf	elfo
aufgelöst	sciolto
übersetzt	tradotto
mädchen	ragazza
glaube	fede
hätten	avessero
wissenschaften	scienze
trug	portava
trug	indossava
architekten	architetti
eduard	eduard
evangelischen	evangelica
herausgeber	editore
einheit	unità
nordosten	nordest
ritter	cavaliere
hersteller	produttore
rückkehr	ritorno
darmstadt	darmstadt
verantwortlich	responsabile
eingerichtet	arredato
angeles	angeles
zeitraum	periodo
tom	tom
menge	folla
menge	quantità
zentimeter	centimetro
besitzen	possedere
hotel	albergo
tübingen	tubinga
parteien	partiti
energie	energia
bürger	cittadino
kennen	conoscere
arthur	arthur
life	life
holstein	holstein
auszeichnungen	riconoscimenti
besuch	visita
definition	definizione
lae	lae
original	originale
prag	praga
bot	bot
verstehen	capire
verstehen	comprendere
ehefrau	moglie
indien	india
beschreibt	descrive
josé	josé
schlecht	male
shift	shift
südwesten	sudovest
politisch	politicamente
leser	lettore
turnier	torneo
körper	corpo
chemie	chimica
bildhauer	scultore
bericht	relazione
untersuchungen	indagini
stattdessen	invece
angriff	attacco
sprechen	parlare
gewonnen	vinto
kontakt	contatto
diskutiert	discusso
luft	aria
mexiko	messico
kommission	commissione
reise	viaggio
entsteht	nasce
gebiete	zone
erhält	riceve
mehrheit	maggioranza
nordwesten	nordovest
datum	data
british	british
marine	marine
variante	variante
tat	tat
deutschsprachigen	germanofona
kalifornien	california
sicherheit	sicurezza
kassel	kassel
meer	mare
theologie	teologia
heft	quaderno
gast	ospite
konzept	concetto
türkei	turchia
bronze	bronzo
entstehen	emergere
begonnen	iniziato
begonnen	iniziata
lieder	canzoni
persönlich	personalmente
verwenden	usare
östlichen	orientale
grenzen	confini
smith	smith
fenster	finestra
unterscheiden	distinguere
farbe	colore
commons	commons
matthias	matthias
rede	discorso
geändert	modificato
russisch	russo
horst	horst
unternehmer	imprenditore
prinzip	principio
struktur	struttura
grafschaft	contea
beruf	professione
südosten	sudest
vierten	quarto
boot	barca
company	company
szene	scena
parlament	parlamento
licht	luce
ausdruck	espressione
oxford	oxford
ungefähr	approssimativamente
verschoben	rinviata
verschoben	spostato
zeigte	mostrò
erwähnung	menzione
lehre	dottrina
lehre	apprendistato
spitze	punta
hugo	hugo
morgen	domani
holz	legno
irgendwie	kinda
qualifikation	qualificazione
qualifikation	qualifica
industrie	industria
trifft	incontra
material	materiale
king	king
manfred	manfred
edward	edward
manche	manche
prozess	processo
best	best
elemente	elementi
existieren	esistere
abitur	maturità
grünen	verdi
anhalt	anhalt
ansicht	visualizza
adam	adam
unbekannt	sconosciuto
halbfinale	semifinale
dänemark	danimarca
bezieht	riferisce
arts	arts
ebenda	ibidem
würzburg	würzburg
imho	imho
kriterien	criteri
standard	standard
pflanzen	piante
landtag	landtag
infanterie	fanteria
brüder	fratelli
förderung	promozione
albrecht	albrecht
kiel	kiel
interview	intervista
spiegel	specchio
ausnahme	eccezione
mecklenburg	meclemburgo
zug	treno
belegen	dimostrano
töchter	figlie
königin	regina
geplant	pianificato
lizenz	licenza
veranstaltungen	eventi
ändern	cambiare
high	high
diskussionen	discussioni
verstanden	capito
nationalsozialismus	nazismo
talk	talk
vertrat	rappresentava
aachen	aquisgrana
figuren	personaggi
italienische	italiana
zentrale	centrale
erlaubt	permessi
abgeschlossen	completato
wiesbaden	wiesbaden
lauf	scappa
verkehr	trasporti
show	spettacolo
gegner	avversario
gekommen	giunto
blau	blu
stern	stella
abs	abs
herstellung	fabbricazione
ausreichend	sufficiente
football	football
antonio	antonio
lee	lee
bestätigt	confermato
israel	israele
brasilien	brasile
klavier	pianoforte
rand	bordo
durchmesser	diametro
gericht	tribunale
barbara	barbara
orchester	orchestra
augsburg	augusta
kennt	conosce
nieder	abbasso
netz	ragnatela
physik	fisica
metal	metal
gouverneur	governatore
belgien	belgio
ähnliche	simili
cambridge	cambridge
auto	macchina
graz	graz
heim	casalingo
magazin	rivista
france	france
francisco	francisco
vergangenheit	passato
presse	pressa
presse	stampa
gegenwart	presente
definiert	definita
definiert	definito
religion	religione
jena	jena
linien	linee
sender	trasmettitore
fallen	trappole
methode	metodo
hektar	ettaro
zweck	scopo
zweck	finalità
gelesen	colto
gründer	fondatore
farben	colori
texas	texas
meyer	meyer
erklärung	dichiarazione
erklärung	spiegazione
handel	commercio
service	servizio
ausland	estero
monat	mese
studenten	studenti
letzter	ultimo
windows	windows
funktionen	funzioni
listen	liste
dinge	cose
lübeck	lubecca
eisenbahn	ferrovie
günter	günter
fließt	scorre
versuchen	provare
einrichtung	arredamento
widerstand	resistenza
design	design
erklären	spiegare
kongress	congresso
volk	popolo
white	white
erstreckt	estende
günther	günther
schwarze	neri
gottfried	gottfried
code	codice
karlsruhe	karlsruhe
grad	gradi
mathematik	matematica
amsterdam	amsterdam
verbessern	migliorare
nsdap	nsdap
vorgesehen	previsto
geschützt	protetto
profil	profilo
wikimedia	wikimedia
las	las
einschließlich	compreso
einschließlich	compresi
millimeter	millimetro
fuß	piede
untersuchung	indagine
züge	treni
portugal	portogallo
angebracht	apposto
vergeben	perdonare
besetzt	occupato
tabelle	tabella
traf	incontrato
zuschauer	spettatore
arnold	arnold
bestehenden	esistente
bestehenden	esistenti
reaktion	reazione
sozialen	sociale
wahlen	elezioni
schriftstellerin	scrittrice
party	festa
entfernen	rimuovere
harry	harry
regionen	regioni
späten	tardo
verfassung	costituzione
getrennt	separato
entfernung	distanza
beendet	terminato
datenbank	database
gefahr	pericolo
minister	ministro
bedarf	fabbisogno
leopold	leopold
plan	piano
interessant	interessante
sowjetischen	sovietica
sowjetischen	sovietico
generation	generazione
wunsch	desiderio
verurteilt	condannato
waffen	armi
dietrich	dietrich
mfg	mfg
schneider	schneider
gemeinschaft	comunità
zugang	accesso
garten	giardino
weisen	saggi
auftritt	apparizione
thüringen	turingia
tonnen	tonnellate
afrika	africa
wagner	wagner
bedingungen	condizioni
niederlande	olanda
hafen	porto
ermöglicht	consente
verbindungen	collegamenti
kontrolle	controllo
rathaus	municipio
emil	emil
schwerpunkt	baricentro
langsam	lento
norwegen	norvegia
angeblich	presumibilmente
sebastian	sebastian
initiative	iniziativa
maßnahmen	misure
oscar	oscar
dritter	terzo
freiheit	libertà
sicherlich	certamente
baron	barone
verschieben	spostare
verschieben	sposta
projekte	progetti
felix	felix
kamera	fotocamera
priester	sacerdote
priester	prete
charakter	carattere
big	big
street	street
organisationen	organizzazioni
ziehen	trascinare
ziehen	tirare
magdeburg	magdeburgo
kommentar	commento
wege	percorsi
time	time
debüt	debutto
eindruck	impressione
gedichte	poesie
produkte	prodotti
donau	danubio
mission	missione
kombination	combinazione
first	first
prinz	principe
endgültig	definitivamente
endgültig	definitivo
kapitel	capitolo
juan	juan
drehbuch	sceneggiatura
versuche	tentativi
alternative	alternativa
sorry	sorry
infrastruktur	infrastruttura
praktisch	praticamente
value	value
jacques	jacques
gründe	motivi
mündet	sfocia
phase	fase
junioren	juniores
françois	françois
behandlung	trattamento
verändert	cambiato
erstellen	creare
unterscheidet	distingue
pokal	coppa
meisterschaften	campionati
jack	jack
handeln	agire
mary	mary
freunde	amici
frieden	pace
stub	stub
bereichen	settori
ruf	reputazione
herz	cuore
handlung	trama
pov	pov
biographie	biografia
eröffnung	inaugurazione
ägypten	egitto
european	european
studio	monolocale
spanisch	spagnolo
not	not
hill	hill
irrelevant	irrilevante
bruno	bruno
regensburg	regensburg
dortmund	dortmund
aktion	azione
mannheim	mannheim
griechenland	grecia
neustadt	neustadt
leo	leo
angebot	offerta
auftreten	comparsa
zweifel	dubbi
reine	pura
township	township
lager	magazzino
beck	beck
jones	jones
blue	blue
umgeben	circondato
kat	kat
net	net
hitler	hitler
wiederholt	ripete
bearbeitungen	lavorazioni
rainer	rainer
übernehmen	assumersi
privaten	privato
brand	brand
mathematiker	matematico
operation	operazione
reden	discorsi
eingebaut	montato
hilft	aiuta
studie	studio
schließen	chiudi
patienten	pazienti
bernd	bernd
vol	vol
anlagen	impianti
flucht	fuga
abt	abate
maschinen	macchine
verbesserung	miglioramento
michel	michel
sonne	sole
sofern	purché
meistens	principalmente
verboten	vietato
erweiterung	allargamento
virginia	virginia
geschichten	storie
modelle	modelli
brown	brown
rajon	rajon
statistik	statistica
erzählt	racconta
weimar	weimar
endlich	finalmente
abend	serata
anne	anne
erfahrungen	esperienze
stellvertretender	vice
falle	trappola
treten	calci
bay	bay
grab	tomba
weber	weber
earl	earl
zieht	tira
getötet	ucciso
samuel	samuel
methoden	metodi
williams	williams
ukraine	ucraina
prix	prix
engagement	impegno
mühle	mulino
rolf	rolf
rostock	rostock
bauern	contadini
linz	linz
demokratischen	democratico
untergebracht	ospitato
funktioniert	funziona
festung	fortezza
joe	joe
rumänien	romania
plätze	piazze
computer	computer
grün	verde
marburg	marburg
east	east
marke	marca
einleitung	introduzione
nachrichten	notizie
kanal	canale
werte	valori
entlassen	licenziato
sprach	parlava
zitat	citazione
krankenhaus	ospedale
dame	dama
diskutieren	discutere
ring	anello
bestehende	esistente
bestehende	esistenti
andré	andré
dynastie	dinastia
bekommt	ottiene
innsbruck	innsbruck
existenz	esistenza
braun	marrone
ziele	obiettivi
bühne	palcoscenico
anerkennung	riconoscimento
konflikt	conflitto
fahrzeug	veicolo
young	young
kandidaten	candidato
rio	rio
vielzahl	varietà
gewalt	violenza
interessiert	interessato
dokumentation	documentazione
krone	corona
amerika	america
format	formato
voll	pieno
anerkannt	riconosciuto
gewinn	profitto
merkmale	caratteristiche
ständig	costantemente
boston	boston
major	major
sächsischen	sassone
stephan	stephan
jacob	jacob
bereit	pronti
langer	langer
gesprochen	parlato
youtube	youtube
erzeugt	generato
venedig	venezia
mündung	foce
rollen	rulli
rollen	ruoli
beteiligung	partecipazione
alpen	alpi
logo	logo
creek	creek
trier	treviri
träger	portatore
madrid	madrid
halbinsel	penisola
carolina	carolina
sekunden	secondi
unterschiedlich	differente
blätter	foglie
lokalen	locale
lokalen	locali
siege	vittorie
volkszählung	censimento
ton	suono
scott	scott
dach	tetto
athen	atene
bgcolor	bgcolor
basiert	basato
sitze	sedili
potsdam	potsdam
besucher	visitatori
mailand	milano
schritt	passo
eberhard	eberhard
arbeiter	operai
militärischen	militare
real	real
kardinal	cardinale
oberfläche	superficie
analyse	analisi
streit	controversia
koch	cuoco
weiterleitung	inoltro
ausstellungen	esposizioni
roger	roger
tempel	tempio
wehrmacht	wehrmacht
vierte	quarta
erfahrung	esperienza
carlos	carlos
denken	pensare
breslau	breslavia
abgelehnt	respinto
umfang	circonferenza
laufen	correre
diesmal	stavolta
kern	nucleo
dörfer	villaggi
bill	bill
dom	duomo
schließt	chiude
brief	lettera
ben	ben
ermöglichen	permettere
force	force
forum	forum
fahren	guidare
preise	prezzi
philosoph	filosofo
goldenen	dorato
times	times
oliver	oliver
ensemble	ensemble
wissenschaftler	scienziato
malerei	pittura
gewicht	peso
erhöht	aumentato
erhöht	aumenta
absolut	assolutamente
ergeben	rivelato
who	oms
who	who
glück	felicità
veränderungen	variazioni
gitarre	chitarra
patrick	patrick
behörden	autorità
rechtsanwalt	avvocato
umwelt	ambiente
ingenieur	ingegnere
manager	manager
senat	senato
reisen	viaggi
rundfunk	radiodiffusione
hoffmann	hoffmann
zugänglich	accessibile
reinhard	reinhard
din	din
erinnerung	promemoria
urteil	sentenza
urteil	giudizio
botschafter	ambasciatore
drehbuchautor	sceneggiatore
eingefügt	inserito
marx	marx
moritz	moritz
fdp	fdp
road	road
üblichen	solita
bauen	costruire
filmografie	filmografia
lord	lord
that	that
auge	occhio
katharina	caterina
geburt	nascita
systeme	sistemi
rose	rose
wales	galles
feuer	fuoco
prüfung	prova
vergessen	dimenticare
day	day
iso	iso
bestanden	superato
gedreht	girato
irland	irlanda
pennsylvania	pennsylvania
eugen	eugen
kunden	clienti
himmel	cielo
hundert	cento
mike	mike
adresse	indirizzo
eingang	entrata
eva	eva
western	western
green	green
sir	signore
anhänger	rimorchi
bearbeitet	lavorati
columbia	columbia
kontext	contesto
sichtbar	visibile
blues	blues
beschlossen	deciso
details	particolari
info	info
planung	pianificazione
leiden	soffrire
leiden	sofferenza
wirtschaftlichen	economico
victor	victor
verstärkt	amplificato
henri	henri
preußischer	preußischer
partner	partner
abkürzung	scorciatoia
abkürzung	abbreviazione
jörg	jörg
masse	massa
rücken	schiena
chris	chris
nationen	nazioni
übersicht	panoramica
test	test
harald	harald
francis	francis
anforderungen	requisiti
schützen	proteggere
beleg	slittamento
verhaftet	arrestato
florida	florida
ausgaben	edizioni
ausgaben	spese
kommunikation	comunicazione
gebrauch	uso
stücke	pezzi
dauer	durata
südafrika	sudafrica
roland	roland
geist	spirito
katalog	catalogo
begrenzt	limitato
vii	vii
argentinien	argentina
episoden	episodi
entwickeln	sviluppare
central	central
siegfried	siegfried
gezogen	tirato
verkauf	vendita
play	play
positiv	positivo
wohnung	appartamento
bass	bass
erfurt	erfurt
goethe	goethe
master	master
ideen	idee
gedanken	pensieri
veranstaltung	evento
hinten	posteriore
niederlanden	bassi
verletzt	ferito
krankheit	malattia
jung	giovane
sehenswürdigkeiten	monumenti
johnson	johnson
jesus	gesù
königsberg	königsberg
getragen	sopportato
transport	trasporto
umsetzung	recepimento
umsetzung	attuazione
flügel	ala
rezeption	reception
kämpfen	lottare
kämpfen	combattere
baum	albero
abhängig	dipendere
gewissen	coscienza
steve	steve
sprecher	portavoce
ohio	ohio
maximilian	massimiliano
mario	mario
wahrheit	verità
istanbul	istanbul
uwe	uwe
unabhängigkeit	indipendenza
gipfel	vetta
pop	pop
beeinflusst	influenzato
vermeiden	evitare
church	church
bauer	bauer
aktive	attivi
rosa	rosa
port	port
verständnis	comprensione
luxemburg	lussemburgo
abgerissen	demolito
ford	ford
begleitet	accompagnato
viertel	quartiere
hauptrolle	protagonista
pläne	piani
victoria	victoria
erworben	acquisito
fakten	fatti
trennung	separazione
budapest	budapest
unterstützte	supportato
charlotte	charlotte
uss	uss
little	little
vorteil	vantaggio
oldenburg	oldenburg
geblieben	rimasto
gerät	dispositivo
grundlagen	fondamenti
wilson	wilson
einstellung	impostazione
varianten	varianti
bielefeld	bielefeld
verbessert	migliora
verbessert	migliorato
altar	altare
tief	profondo
runden	giri
utc	utc
zeitschriften	riviste
illinois	illinois
chronik	cronaca
fach	divisorio
enzyklopädische	enciclopedica
public	public
identisch	identico
aussehen	aspetto
gefängnis	prigione
gesucht	cercasi
gesucht	ricercato
drama	dramma
marc	marc
manuel	manuel
renaissance	rinascimento
sturm	tempesta
umstritten	controverso
kurzfilm	cortometraggio
prinzessin	principessa
geschwindigkeit	velocità
bob	bob
exemplare	esemplari
davis	davis
bernard	bernard
jerusalem	gerusalemme
traditionellen	tradizionale
kino	cinema
übergang	transizione
ball	palla
woiwodschaft	voivodato
lernen	imparare
tunnel	tunnel
provinzen	province
marcus	marcus
minute	minuto
verteilt	distribuito
gefallen	caduto
massachusetts	massachusetts
griechisch	greco
great	great
stockholm	stoccolma
produkt	prodotto
porträt	ritratto
vorgänger	predecessore
autobahn	autostrada
gestern	ieri
umgewandelt	convertito
keller	cantina
gutes	buon
ansatz	approccio
abgeordneten	deputato
taylor	taylor
flagge	bandiera
italienisch	italiano
schottland	scozia
verteidigung	difesa
finnland	finlandia
etappe	tappa
mauer	muro
redaktion	redazione
strukturen	strutture
überall	ovunque
gelb	giallo
nachfolge	successione
absatz	paragrafo
arrondissement	arrondissement
bekannter	conoscente
leichtathletik	atletica
strom	elettricità
golden	golden
integriert	integrato
spuren	tracce
schwierig	difficile
benjamin	benjamin
konzert	concerto
jahrbuch	annuario
verfügte	disponeva
milliarden	miliardi
beobachtet	osservato
gang	gang
last	last
angabe	indicazione
lehrte	insegnato
tirol	tirolo
beinhaltet	include
claude	claude
zdf	zdf
tony	tony
schaden	danno
zeitungen	giornali
aspekte	aspetti
iran	iran
seen	laghi
kabinett	gabinetto
normalerweise	solitamente
assistent	assistente
warten	aspettando
andrew	andrew
register	registro
douglas	douglas
festgestellt	accertato
beginnen	iniziare
koblenz	coblenza
becker	becker
flotte	flotta
flugzeug	aereo
server	server
kritisiert	criticato
angst	ansia
angst	paura
innen	dentro
konzerte	concerti
erwin	erwin
bochum	bochum
bearbeiten	modifica
legende	leggenda
box	box
besatzung	equipaggio
game	game
botschaft	ambasciata
brunnen	pozzo
technisch	tecnicamente
legt	espone
flora	flora
sätze	frasi
paderborn	paderborn
direkten	diretto
night	night
museen	musei
indischen	indiano
symbol	simbolo
eric	eric
verfügbar	disponibile
brüssel	bruxelles
ermordet	assassinato
ermordet	assassinati
parameter	parametri
getroffen	colpito
reduziert	ridotto
gegenstand	oggetto
unterschiede	differenze
engel	angelo
angepasst	adattato
holte	holte
lokomotiven	locomotive
stationen	stazioni
warschau	varsavia
fertig	finito
haltung	atteggiamento
erfüllen	adempiere
phil	phil
höhepunkt	culmine
nhl	nhl
nachkommen	discendenti
liter	litro
liter	litri
andrea	andrea
kindheit	infanzia
wind	vento
darstellungen	rappresentazioni
angesprochen	sollevato
umsatz	fatturato
menschlichen	umano
weiler	weiler
gezählt	contato
gezählt	contate
wächst	cresce
positionen	posizioni
chile	cile
lewis	lewis
petersburg	pietroburgo
out	out
synagoge	sinagoga
nationalsozialisten	nazionalsocialisti
wild	wild
regionale	regionale
jackson	jackson
analog	analogico
long	long
szenen	scene
kanadischen	canadese
böhmen	boemia
islam	islam
untersucht	esplora
annahme	accettazione
annahme	adozione
oberst	colonnello
nation	nazione
präsentiert	presentato
haut	pelle
modern	moderno
ray	ray
schwierigkeiten	difficoltà
eigentümer	proprietario
são	são
gefördert	promosso
gabriel	gabriel
beschädigt	danneggiato
neutral	neutrale
pommern	pomerania
schwerin	schwerin
christen	cristiani
saale	saale
anfrage	richiesta
gekennzeichnet	contrassegnato
vertical	vertical
hoffnung	speranza
stephen	stephen
class	class
lösen	risolvere
ausgebildet	addestrato
valign	valign
erbe	eredità
plötzlich	improvvisamente
elektrische	elettrico
elektrische	elettrici
nassau	nassau
ruhestand	pensionamento
sophie	sophie
mittelalterlichen	medievale
voraus	anticipo
sonntag	domenica
arena	arena
christus	cristo
verlust	perdita
this	this
verlängert	prolungato
heilbronn	heilbronn
null	zero
law	law
book	book
bezeichnungen	denominazioni
uefa	uefa
gräfin	contessa
duisburg	duisburg
blut	sangue
ersetzen	sostituisci
ersetzen	sostituire
erzählung	narrazione
pseudonym	pseudonimo
auswirkungen	effetti
lat	lat
einiges	alcuno
bremer	bremer
erfährt	sperimenta
ausführung	esecuzione
mord	omicidio
jäger	cacciatore
spielfilm	lungometraggio
ruhr	dissenteria
carlo	carlo
oskar	oskar
tourismus	turismo
centre	centre
vogel	uccello
fassade	facciata
sprint	sprint
worte	parole
norbert	norbert
hessischen	hessische
franken	franchi
lady	lady
abtei	abbazia
saarbrücken	saarbrücken
adler	aquila
lebenden	vivi
ursache	causa
zerstörung	distruzione
beschreiben	descrivere
kathedrale	cattedrale
debütierte	debuttato
luis	luis
stahl	acciaio
rené	rené
entscheidungen	decisioni
besucht	visitato
plus	plus
ruhe	riposo
wuppertal	wuppertal
georges	georges
horn	corno
institutionen	istituzioni
konsens	consenso
sydney	sydney
geräte	dispositivi
erwarten	aspettarsi
selbstverständlich	scontato
schnitt	taglio
ali	ali
klassen	classi
ibn	ibn
nrw	nrw
abstieg	discesa
space	space
umgekehrt	viceversa
anthony	anthony
brian	brian
siedlungen	insediamenti
asien	asia
pianist	pianista
old	old
blatt	foglia
blatt	foglio
hildesheim	hildesheim
geschlagen	battuto
bekanntheit	notorietà
programme	programmi
befehl	comando
bestimmung	determinazione
free	free
marathon	maratona
demokratie	democrazia
tier	animale
bnr	bnr
geschlecht	sesso
instrument	strumento
angezeigt	visualizzato
prof	prof
kopenhagen	copenaghen
rücktritt	dimissioni
summe	somma
rektor	rettore
sage	sage
klingt	suona
klingt	suoni
musical	musical
jersey	jersey
osnabrück	osnabrück
antworten	risposte
witwe	vedova
hart	hart
zeichnungen	disegni
gerd	gerd
gespräch	colloquio
reserve	riserva
kräfte	forze
kim	kim
year	year
bewertung	valutazione
jugendliche	adolescenti
genf	ginevra
verdacht	sospetto
tokio	tokyo
erlebte	sperimentato
hügel	collina
junior	junior
materialien	materiali
onkel	zio
end	end
abstimmung	votazione
wein	vino
gegenteil	contrario
business	business
richtlinien	direttive
element	elemento
bucht	baia
reiste	viaggiato
fortsetzung	continuazione
natürliche	naturale
büro	ufficio
plattform	piattaforma
auseinandersetzungen	scontri
gewinnt	vince
ulm	ulm
regelung	regime
ard	ard
diplom	diploma
verfolgung	persecuzione
motiv	movente
usd	usd
gray	gray
jura	giura
kaiserlichen	imperiale
bachelor	bachelor
johanna	giovanna
versorgung	approvvigionamento
straßburg	strasburgo
alan	alan
may	may
temperatur	temperatura
komödie	commedia
fans	tifosi
getan	fatto
costa	costa
wiederaufbau	ricostruzione
hollywood	hollywood
toronto	toronto
ernennung	nomina
bulgarien	bulgaria
christopher	christopher
philadelphia	philadelphia
verbot	divieto
vollständige	completi
zellen	celle
walther	walther
identität	identità
tot	morto
boote	barche
hagen	hagen
fotograf	fotografo
stars	stars
hit	hit
can	can
champions	champions
sang	sang
miller	miller
alex	alex
verhindert	impedisce
verhindert	impedito
brigade	brigata
sed	sed
jenseits	aldilà
council	council
gitarrist	chitarrista
flugzeuge	aerei
michigan	michigan
howard	howard
viii	viii
steiermark	stiria
gewinner	vincitore
gewinner	vincitori
amerikaner	americani
gesundheit	salute
premiere	premiere
special	special
marco	marco
verantwortung	responsabilità
lorenz	lorenz
polnisch	polacco
klima	clima
geschickt	inviato
bestimmen	determinare
briefe	lettere
hamilton	hamilton
flug	volo
schatten	ombra
dan	dan
project	project
minnesota	minnesota
übersetzer	traduttore
ausgestellt	rilasciato
ersatz	sostituzione
erkennt	rileva
erkennt	riconosce
löwen	leoni
jagd	caccia
unsinn	sciocchezze
volker	volker
sitzen	seduto
typisch	tipico
parks	parchi
argumentation	ragionamento
straßenbahn	tram
christine	christine
verordnung	regolamento
ministerium	ministero
zurückgezogen	ritirata
zurückgezogen	ritirato
express	express
begriffsklärung	disambigua
jim	jim
disziplin	disciplina
dokumente	documenti
einsätze	puntate
point	point
basketball	pallacanestro
florenz	firenze
konferenz	convegno
konferenz	conferenza
bamberg	bamberg
dokumentiert	documentato
vergleichbar	comparabile
vergleichbar	paragonabile
schönen	stupende
lothar	lothar
ausgewählt	selezionato
clemens	clemens
death	death
tschechoslowakei	cecoslovacchia
are	are
julia	giulietta
belagerung	assedio
legen	stabiliscono
model	model
model	modella
sun	sun
datiert	datato
francesco	francesco
motoren	motori
klinik	clinica
religiöse	religiosi
lippe	labbro
konstanz	costanza
behauptung	affermazione
schicksal	destino
act	act
bibel	bibbia
unentschieden	pareggio
verschiebung	spostamento
schwestern	sorelle
jahrzehnte	decenni
hubert	hubert
vorbereitung	preparazione
inklusive	incluso
harvard	harvard
mengen	quantitativi
nick	nick
sam	sam
schäden	danni
conrad	conrad
romane	romanzi
jap	jap
fusion	fusione
integration	integrazione
valley	valley
ips	ips
pedro	pedro
schade	peccato
achten	ottavo
festen	fisso
wiederherstellung	ripristino
messe	fiera
tim	tim
schlesien	slesia
ablauf	scadenza
news	news
zimmer	camere
bewegen	muoversi
wahrnehmung	percezione
contra	contra
nutzt	sfrutta
schlagzeuger	batterista
anwendungen	applicazioni
bundestag	bundestag
women	women
dick	dick
gründeten	fondarono
ehemann	marito
wachsen	crescere
eis	gelato
griff	manico
erfinder	inventore
samt	velluto
präfektur	prefettura
lehrstuhl	cattedra
archäologie	archeologia
freundin	amica
stamm	tribù
willi	willi
berater	consigliere
berater	consulente
qualifiziert	qualificati
jury	giuria
formal	formalmente
geteilt	condiviso
gesicht	faccia
gesicht	viso
gesicht	volto
unfall	incidente
atlas	atlas
sterben	morire
abschnitte	sezioni
zitiert	citato
einspruch	obiezione
platte	piastra
eroberung	conquista
sand	sabbia
index	indice
heide	brughiera
championship	championship
monte	monte
wesen	essenza
brauerei	birreria
zeugen	testimoni
roth	roth
gefahren	pericoli
philip	philip
slowakei	slovacchia
luther	luther
dfb	dfb
gefärbt	colorati
formulierung	formulazione
vögel	uccelli
kommunistischen	comunista
ursula	ursula
willy	willy
alice	alice
pflanze	pianta
hund	cane
nachruf	necrologio
ding	ding
briten	britannici
scheinbar	apparentemente
jahrgang	annata
exil	esilio
soldat	soldato
eigentum	proprietà
leer	vuoto
neapel	napoli
entdeckung	scoperta
fuchs	volpe
verdient	meritato
beobachten	osservare
block	blocco
dokumentarfilm	documentario
sammeln	raccogliere
dauerhaft	permanentemente
angriffe	attacchi
klären	chiarire
jens	jens
hell	hell
ausgewiesen	espulso
wörterbuch	dizionario
nebenfluss	affluente
ralf	ralf
gordon	gordon
sports	sports
niederlagen	sconfitte
stift	penna
maurice	maurice
kpd	kpd
überzeugt	convinto
überzeugt	convinti
missouri	missouri
freundschaft	amicizia
overs	overs
elizabeth	elizabeth
sekretär	segretario
fred	fred
beenden	esci
johnny	johnny
testament	testamento
diözese	diocesi
abgrenzung	delimitazione
arm	braccio
samen	semi
glocken	campane
unterscheidung	distinzione
peking	pechino
journalisten	giornalisti
florian	florian
hits	hits
pflege	cura
gewidmet	dedicato
hanau	hanau
corporation	corporation
hochzeit	matrimonio
kapazität	capacità
formuliert	formulato
hms	hms
ltd	ltd
bbc	bbc
technology	technology
personal	personale
netzwerk	rete
erziehung	educazione
vorwurf	rimprovero
verbände	associazioni
neumann	neumann
technologie	tecnologia
#aaa	#aaa
wittenberg	wittenberg
nachricht	messaggio
redakteur	redattore
bmw	bmw
infobox	infobox
gefangen	catturato
ausgesprochen	pronunciato
statue	statua
extra	extra
gruss	saluto
mythologie	mitologia
axel	axel
abraham	abraham
verzeichnis	directory
inhaber	titolare
therapie	terapia
synonym	sinonimo
historic	historic
kommentare	commenti
hahn	gallo
überflüssig	superfluo
erwartet	atteso
meinungen	opinioni
flüsse	fiumi
kämpfe	combatti
million	milione
global	global
abenteuer	avventura
haft	detenzione
jugoslawien	iugoslavia
verkaufen	vendere
beherbergt	ospita
kroatien	croazia
teilnehmen	partecipare
giuseppe	giuseppe
territorium	territorio
zulassung	ammissione
kärnten	carinzia
wurzeln	radici
asteroid	asteroide
sammlungen	collezioni
thailand	thailandia
steine	pietre
racing	racing
entscheidend	decisivo
markiert	segnato
markiert	taggate
neckar	neckar
gemessen	misurato
instrumente	strumenti
bischöfe	vescovi
verluste	perdite
schwach	debole
prince	prince
two	two
clark	clark
sterne	stelle
gefällt	piace
vorstellen	immaginare
breisgau	breisgau
erreichbar	raggiungibile
zwecke	scopi
erik	erik
angelegenheiten	affari
marcel	marcel
durchschnittlich	mediamente
enthielt	conteneva
berger	berger
völker	popoli
philippe	philippe
microsoft	microsoft
konkret	concretamente
fabrik	fabbrica
dauerte	durato
jahrhunderte	secoli
anmerkung	nota
produktionen	produzioni
linux	linux
tausend	mille
duke	duke
training	allenamento
thüringer	thüringer
orange	arancione
tür	porta
syndrom	sindrome
sultan	sultano
zusammensetzung	composizione
fliegen	volare
mitbegründer	cofondatore
soziologie	sociologia
jimmy	jimmy
finanzielle	finanziario
schild	scudo
hartmann	hartmann
römer	romani
übertragung	trasferimento
biologie	biologia
wisconsin	wisconsin
aires	aires
indiana	indiana
gefragt	chiesto
informiert	informato
tanz	danza
glas	vetro
mayer	mayer
wladimir	vladimir
kauf	acquisto
anderson	anderson
atp	atp
bergbau	miniere
these	tesi
prozesse	processi
gelöst	risolto
buenos	buenos
geschätzt	stimato
geschätzt	apprezzato
waffe	arma
trugen	portavano
dance	dance
beurteilen	giudicare
trio	trio
val	val
ice	ice
charlie	charlie
negativ	negativo
senator	senatore
streifen	striscia
kennzeichen	targa
entworfen	progettato
down	down
turin	torino
berichtete	segnalato
verwandt	correlare
literarische	letterario
typen	tipi
adams	adams
begraben	sepolto
betreiber	operatore
geschieht	accade
louise	louise
stanley	stanley
url	url
pass	passaporto
nahrung	alimento
sichern	ausiliario
hängen	appendere
doktor	dottore
fulda	fulda
verbrechen	delitto
verbrechen	crimine
debatte	dibattito
eisen	ferro
seele	anima
becken	bacino
wdr	wdr
bit	bit
missbrauch	abuso
wiederhergestellt	ripristinato
bogen	arco
ehrlich	onesto
kritisch	critico
csu	csu
knoten	nodo
realität	realtà
mercedes	mercedes
campus	campus
gebraucht	usato
stellvertreter	supplente
stellvertreter	supplenti
bäume	alberi
napoleon	napoleone
fünfte	quinta
liefern	consegnare
what	what
brücken	ponti
unmöglich	impossibile
bridge	bridge
nicolas	nicolas
pferd	cavallo
vergleiche	confronti
vincent	vincent
lebensraum	habitat
queen	queen
chemnitz	chemnitz
wählen	scegliere
intensiv	intensivo
intensiv	intenso
hinzugefügt	aggiunto
övp	övp
hände	mani
akademischen	accademico
säulen	pilastri
duo	duo
udssr	urss
graben	scavare
bus	autobus
bataillon	battaglione
sarah	sarah
winkel	angolo
erneuert	rinnovato
ausgerichtet	allineato
nacional	nacional
pferde	cavalli
steiner	steiner
railway	railway
höchstens	massimo
kriterium	criterio
lutherischen	luterana
münzen	monete
lüneburg	lüneburg
admiral	ammiraglio
admiral	admiral
edgar	edgar
helsinki	helsinki
übliche	solita
sabine	sabine
alois	alois
greifswald	greifswald
wiesen	prati
edmund	edmund
boris	boris
sag	dillo
höhle	grotta
nisi	nisi
bruce	bruce
palast	palazzo
wahrscheinlichkeit	probabilità
lyon	lione
ausrichtung	allineamento
archäologische	archeologico
magnus	magnus
freiwillige	volontari
böse	cattivo
manchester	manchester
back	back
serbien	serbia
küche	cucina
ontario	ontario
messen	fiere
taschenbuch	paperback
dirk	dirk
badminton	badminton
geöffnet	aperto
veränderung	variazione
schröder	schröder
zeichner	disegnatore
definitiv	decisamente
benz	benz
stirbt	muore
spö	spö
modus	modalità
schuld	debito
diego	diego
panzer	panzer
rekord	record
fördern	promuovere
kevin	kevin
ausgesetzt	sospesa
verteilung	distribuzione
restaurant	ristorante
piloten	piloti
kurfürst	kurfürst
luzern	lucerna
restauriert	restaurato
jane	jane
theorien	teorie
ruth	ruth
cross	cross
his	his
good	good
htm	htm
klare	chiara
grau	grigio
moore	moore
krise	crisi
billy	billy
glocke	campana
lissabon	lisbona
forscher	esploratore
forscher	ricercatori
dran	sintonizzati
phänomen	fenomeno
einkommen	reddito
mandat	mandato
echt	genuino
erzbistum	arcidiocesi
bildenden	figurative
kansas	kansas
opposition	opposizione
logik	logica
aufhebung	abrogazione
unabhängigen	indipendente
mischung	miscela
stammten	provenivano
pour	pour
inc	inc
claus	claus
colorado	colorado
übersetzungen	traduzioni
kompositionen	composizioni
gotha	gotha
vandale	vandalo
dichte	densità
verursacht	causato
place	place
spät	tardi
gnu	gnu
enkel	nipoti
encyclopedia	encyclopedia
danzig	danzica
experten	esperti
ralph	ralph
liberalen	liberali
normal	normale
besuchen	visitare
vorübergehend	temporaneamente
reform	riforma
institution	istituzione
paulo	paulo
chefredakteur	caporedattore
mond	luna
verfasser	autore
gas	gas
verwaltet	gestito
autos	automobili
austausch	scambio
finanzierung	finanziamento
dringend	urgente
überzeugen	convincere
century	century
stone	stone
töten	uccidere
raymond	raymond
dna	dna
anbau	coltivazione
angebaut	coltivato
hammer	martello
unterbrochen	interrotto
genehmigung	approvazione
ausnahmen	eccezioni
administrator	amministratore
entwicklungen	sviluppi
verletzung	lesione
eintritt	ingresso
erhebt	riscuote
roy	roy
gottlieb	gottlieb
girl	girl
sozialistischen	socialista
spektrum	spettro
erben	ereditare
viktor	viktor
installiert	installato
marketing	marketing
people	people
stadium	stadium
archäologischen	archeologici
donald	donald
regelmäßige	regolare
humboldt	humboldt
eier	uova
oslo	oslo
eingeladen	invitato
angrenzenden	adiacente
publizist	pubblicista
light	light
ross	ross
thai	thai
thai	tailandese
antrieb	azionamento
urban	urban
men	men
jonathan	jonathan
memorial	memorial
gegangen	andato
gestartet	lanciato
gestartet	avviato
nelson	nelson
part	part
speyer	speyer
iowa	iowa
australian	australian
finanziert	finanziato
überraschend	sorprendentemente
zürcher	zurighese
konservativen	conservatori
schichten	strati
ten	rte
khan	khan
tsv	tsv
regen	pioggia
mac	mac
fox	fox
verweist	rinvia
boxer	boxer
violine	violino
erhaltung	conservazione
río	río
bell	bell
herzen	cuori
diss	diss
denis	denis
litauen	lituania
theologischen	teologico
premier	premier
reinen	puro
dos	dos
akten	schedario
verbinden	unire
rtl	rtl
ruhig	tranquillo
planeten	pianeti
platzierung	posizionamento
überschrift	intestazione
just	just
verteidiger	difensore
second	second
artillerie	artiglieria
family	family
steuern	tasse
wolff	wolff
welle	onda
versammlung	assemblea
richtlinie	direttiva
range	range
sizilien	sicilia
fifa	fifa
ablehnung	rifiuto
zimmermann	zimmermann
kriege	guerre
antragsteller	richiedente
melden	segnalare
elektronische	elettronica
nikolai	nikolaj
stock	bastone
mississippi	mississippi
orf	orf
insekten	insetti
feat	feat
schulz	schulz
übernahmen	acquisizioni
claudia	claudia
spaß	divertimento
vorläufer	precursore
verlässt	abbandona
tennessee	tennessee
tageszeitung	quotidiano
gen	gen
widerspruch	contraddizione
bedenken	preoccupazioni
aufenthalt	soggiorno
komponenten	componenti
walker	walker
profi	professionista
var	var
empire	empire
tennis	tennis
hotels	alberghi
robin	robin
vertrauen	fiducia
bier	birra
baby	baby
worms	worms
spur	traccia
gefeiert	celebrato
gefeiert	festeggiato
märchen	fiabe
lieben	amare
lieben	amori
lösungen	soluzioni
wetter	meteo
freitag	venerdì
akzeptiert	accetta
akzeptiert	accettato
irak	iraq
jordan	jordan
ian	ian
evolution	evolution
dead	dead
absolute	assoluto
schwaben	schwaben
ausgrabungen	scavi
kaufen	comprare
forderungen	crediti
islamischen	islamico
informatik	informatica
grube	buca
zeile	riga
ausgerüstet	equipaggiato
antoine	antoine
zusammenfassung	riassunto
zusammenfassung	sintesi
zusammenfassung	sommario
platzierungen	posizionamenti
risiko	rischio
bande	banda
veröffentlichen	pubblicare
cover	copertina
auguste	auguste
philippinen	filippine
lawrence	lawrence
metall	metallo
lothringen	lorena
borussia	borussia
mode	moda
update	aggiornamento
geliefert	consegnato
vorderen	anteriore
russell	russell
development	development
konstantin	costantino
ann	ann
reinhold	reinhold
großvater	nonno
gefühl	sensazione
montreal	montreal
wachstum	crescita
gäste	ospiti
passau	passau
qualifizieren	qualificare
vorteile	vantaggi
ungewöhnlich	insolito
gärten	giardini
wolle	lana
berechnung	calcolo
kulturen	colture
way	way
konflikte	conflitti
helden	eroi
gesamt	totale
öffnen	aprire
hört	udite
jochen	jochen
entscheidet	decide
schlägt	batte
pastor	pastore
erwähnen	accennare
besonderheiten	particolarità
korea	corea
gebunden	vincolato
mdl	mdl
syrien	siria
dark	dark
nasa	nasa
geschäfte	negozi
temperaturen	temperature
ostsee	baltico
finnischen	finlandese
fake	falso
fake	fake
bayer	bayer
agnes	agnese
fleisch	carni
moschee	moschea
sparkasse	sparkasse
verliert	perde
handball	pallamano
praktische	pratico
slalom	slalom
orientiert	orientato
orientiert	orientata
erweitern	espandere
erweitern	ampliare
pfund	sterlina
theory	theory
osmanischen	ottomano
stationiert	situa
limburg	limburgo
human	human
bestellt	ordinato
wahrgenommen	percepito
wahrgenommen	percepita
frederick	frederick
beliebt	popolare
fernando	fernando
bayreuth	bayreuth
abkommen	accordo
stuart	stuart
siedler	coloni
hot	hot
board	board
kanzel	pulpito
gehandelt	agito
bewohnt	abitato
laden	negozio
bewertet	valutato
weser	weser
gefordert	sollecitato
kirchlichen	ecclesiastici
guy	guy
nova	nova
zweig	ramo
felder	campi
spannung	tensione
medium	medium
dave	dave
achse	asse
bewegungen	movimenti
christentum	cristianesimo
fähigkeit	capacità
fürstentum	principato
verteidigen	difendere
verletzungen	lesioni
atelier	atelier
triebwagen	automotrici
bgb	bgb
reaktionen	reazioni
schmid	schmid
tobias	tobias
greift	attacca
lutz	lutz
continental	continental
stettin	stettino
facebook	facebook
tisch	tavolo
angegriffen	attaccato
huber	huber
reagiert	reagisce
betont	sottolineato
betont	sottolinea
body	body
vfl	vfl
faktoren	fattori
skulpturen	sculture
sea	sea
banken	banche
coburg	coburgo
geographie	geografia
kai	kai
kentucky	kentucky
behandeln	trattare
gekauft	acquistato
loch	buco
busch	busch
koordinaten	coordinate
matt	matt
kaserne	caserma
boy	boy
verständlich	comprensibile
mars	marte
mars	mars
pacific	pacific
gewöhnlich	tipicamente
bemerkt	notato
ferrari	ferrari
maus	mouse
signal	segnale
edinburgh	edimburgo
peru	perù
heart	heart
verliebt	innamorato
bibliotheken	biblioteche
kuba	cuba
stört	disturba
organist	organista
lloyd	lloyd
strand	spiaggia
bruch	rottura
like	like
miss	miss
wider	opponente
erhöhen	aumentare
kavallerie	cavalleria
begleitete	accompagnò
motto	motto
notwendigkeit	necessità
zulässig	ammissibile
engen	stretto
caspar	caspar
miguel	miguel
half	half
wall	wall
afghanistan	afghanistan
moderator	moderatore
adel	nobiltà
pas	pas
bat	bat
hubraum	cilindrata
café	caffetteria
okay	ok
gary	gary
stewart	stewart
ursachen	cause
autonomen	autonomi
autonomen	autonomo
autonomen	autonome
befreiung	liberazione
zoll	dogana
hingerichtet	giustiziato
about	about
lese	leggo
wunder	meraviglia
vorsprung	linguetta
bottom	bottom
finger	dito
finger	dita
sanierung	risanamento
geheimnis	segreto
andy	andy
lost	lost
zeitgenössischen	contemporaneo
stufen	gradini
fellow	fellow
java	java
ebenen	livelli
mountain	mountain
domain	dominio
versteckt	nascosto
schlüssel	chiavi
katholiken	cattolici
reichstag	reichstag
strafe	punizione
brust	petto
zeilen	righe
gulden	fiorino
lisa	lisa
angekündigt	annunciato
planet	pianeta
mozart	mozart
angewandte	applicata
einflüsse	influenze
erdgeschoss	pianterreno
traum	sogno
allianz	alleanza
pietro	pietro
barock	barocco
pilot	pilota
abgebildet	raffigurato
universal	universal
cruz	cruz
verstorben	deceduto
geologie	geologia
melbourne	melbourne
kolonien	colonie
lausanne	losanna
klammern	parentesi
verwandte	correlati
verwandte	parenti
unterkategorien	sottocategorie
kampagne	campagna
nba	nba
beobachtung	osservazione
hoffentlich	speriamo
detail	dettaglio
problematisch	problematico
sicherung	fusibile
felsen	roccia
arme	braccia
arme	povera
höhen	altezze
airlines	airlines
kalender	calendario
blog	blog
malerin	pittrice
wiederwahl	rielezione
erfindung	invenzione
xii	xii
hals	collo
maría	maría
schlösser	castelli
olympia	olympia
bemühungen	sforzi
johan	johan
margaret	margaret
wochenende	weekend
arizona	arizona
sprung	crepa
franklin	franklin
bde	bde
flüchtlinge	profughi
flüchtlinge	rifugiati
koalition	coalizione
skulptur	scultura
rue	rue
vermittlung	mediazione
informieren	informare
seminar	seminario
substanz	sostanza
harris	harris
generationen	generazioni
janeiro	janeiro
vancouver	vancouver
ausrüstung	attrezzatura
ronald	ronald
minderheit	minoranza
peters	peters
niederländisch	olandese
beamten	funzionari
klagenfurt	klagenfurt
kupfer	rame
lincoln	lincoln
sandstein	arenaria
bedeuten	significare
field	field
marken	marche
studieren	studiare
rezension	recensione
fische	pesci
schiller	schiller
sven	sven
fordert	invita
fordert	sollecita
kleidung	abbigliamento
erlaubnis	permesso
unterhält	mantiene
norman	norman
atmosphäre	atmosfere
siemens	siemens
mini	mini
ernest	ernest
kreuzer	incrociatore
erdbeben	terremoto
puerto	puerto
besaßen	possedevano
son	son
rückseite	retro
lokomotive	locomotiva
vermutung	congettura
propaganda	propaganda
spalte	colonna
southern	southern
oswald	oswald
beschäftigten	addetti
lkw	camion
registriert	registrati
registriert	registrato
verschwinden	scomparire
magdalena	maddalena
magdalena	magdalena
spenden	donare
spenden	donazioni
earth	earth
boys	boys
mdr	mdr
monarchie	monarchia
bestätigen	confermare
scharf	piccante
frisch	freschi
kelly	kelly
alabama	alabama
dokument	documento
loire	loira
kette	catena
schicht	strato
alberto	alberto
mittelmeer	mediterraneo
faktor	fattore
ermordung	assassinio
connecticut	connecticut
persönlichkeit	personalità
kaliningrad	kaliningrad
zusatz	aggiunta
guido	guido
xvi	xvi
abbau	degradazione
vietnam	vietnam
strategie	strategia
uruguay	uruguay
liechtenstein	liechtenstein
holocaust	olocausto
siegel	sigillo
quer	trasversale
hamm	hamm
auschwitz	auschwitz
detroit	detroit
emma	emma
krankheiten	malattie
bukarest	bucarest
mans	mans
maine	maine
rief	gridò
entlassung	licenziamento
kongo	congo
stämme	ceppi
siebten	settimo
grob	grossolanamente
dialekt	dialetto
philologie	filologia
hofmann	hofmann
grimm	grimm
orthodoxen	ortodossi
orthodoxen	ortodosso
rechnung	fattura
browser	browser
historical	historical
draft	draft
benannten	designato
eintracht	concordia
rad	ruota
vfb	vfb
lass	lascia
harz	resina
beitragen	contribuire
lars	lars
kopiert	copiato
lucas	lucas
schiedsrichter	arbitro
dünn	sottile
bestimmungen	disposizioni
mauern	mura
berechnet	calcola
three	three
verlieren	perdere
gefangenschaft	cattività
henning	henning
sainte	sainte
moon	moon
teufel	diavoli
notre	notre
leinwand	tela
hörspiel	radiodramma
rugby	rugby
verarbeitet	trasformati
kameramann	cameraman
funktionieren	funzionamento
madonna	madonna
roberto	roberto
wohnen	abitare
vorfahren	antenati
ressourcen	risorse
laura	laura
marianne	marianne
mathias	mathias
österreichisch	austro
rumpf	scafo
lyrik	lirica
belgrad	belgrado
maryland	maryland
abhängigkeit	dipendenza
mörder	assassino
sofia	sofia
abu	abu
glasgow	glasgow
stürmer	attaccante
heller	heller
emanuel	emanuel
kohle	carbone
graham	graham
caroline	caroline
marokko	marocco
nordischen	nordico
wrestling	wrestling
ryan	ryan
manga	manga
demo	demo
renault	renault
turner	turner
einnahmen	entrate
dorothea	dorotea
renoviert	ristrutturato
suhrkamp	suhrkamp
kreuzung	incrocio
gilbert	gilbert
captain	capitano
kirchliche	ecclesiastica
ausgang	uscita
estland	estonia
clara	clara
nad	nad
anzeige	annuncio
sierra	sierra
forest	forest
meißen	meißen
trennen	separare
sogn	sogn
stralsund	stralsund
spezialisiert	specializzata
kennedy	kennedy
karin	karin
händler	rivenditore
mönchengladbach	mönchengladbach
germanistik	germanistica
singen	cantare
camp	camp
minden	minden
campbell	campbell
mind	mind
beine	gambe
lig	lig
techniken	tecniche
asteroiden	asteroidi
franco	franco
überprüfung	revisione
böden	pavimenti
option	opzione
ägyptischen	egiziano
stade	stade
morgan	morgan
bühnen	palcoscenici
porsche	porsche
flecken	macchie
japanisch	giapponese
sat	sat
fliehen	fuggire
stoffe	sostanze
château	château
fraglich	discutibile
steven	steven
parker	parker
empfangen	ricevi
empfangen	ricevere
diff	diff
pflicht	dovere
talent	talento
fire	fire
türkisch	turco
passagiere	passeggeri
wusste	sapeva
theologische	teologiche
hanns	hanns
thompson	thompson
konstantinopel	costantinopoli
henriette	henriette
four	four
dichtung	guarnizione
theoretisch	teoricamente
robinson	robinson
decken	coperte
hop	hop
legend	legend
wünsche	desideri
dennis	dennis
nachbarn	vicini
ernährung	nutrizione
bologna	bologna
vergleichen	confrontare
björn	björn
kolumbien	colombia
tafel	lavagna
download	scarica
dublin	dublino
gabriele	gabriele
planck	planck
fantasy	fantasy
springen	saltare
luigi	luigi
gedruckt	stampato
abteilungen	divisioni
störungen	disturbi
ken	ken
halbe	mezza
louisiana	louisiana
nachweisbar	rilevabili
nachweisbar	rilevabile
taiwan	taiwan
vorzeitig	prematuramente
aufzeichnungen	annotazioni
aufzeichnungen	registrazioni
amazon	amazon
teilgenommen	partecipato
shakespeare	shakespeare
hang	hang
labor	laboratorio
samstag	sabato
lehmann	lehmann
classic	classic
med	med
student	studente
berühmt	famoso
restaurierung	restauro
geehrt	onorato
jonas	jonas
umzug	trasloco
ski	sci
held	eroe
erhöhung	aumento
erhöhung	spinta
wüste	deserto
adolph	adolph
mhz	mhz
uci	uci
carter	carter
princeton	princeton
latein	latino
fortgesetzt	continuato
atlanta	atlanta
hip	hip
antwerpen	anversa
kaiserslautern	kaiserslautern
bks	bks
invasion	invasione
muhammad	muhammad
northern	northern
julian	julian
nil	nilo
alternativen	alternative
sant	sant
altenburg	altenburg
abc	abc
herrscht	regna
schaffung	creazione
kiew	kiev
hard	hard
wiedergänger	revenant
faust	pugno
unverändert	invariato
evans	evans
holding	holding
apple	apple
schwanz	coda
fisch	pesce
thron	trono
rapper	rapper
ozean	oceano
konservatorium	conservatorio
untergrund	underground
untergrund	sottosuolo
redundanz	ridondanza
senior	senior
more	more
nachkriegszeit	dopoguerra
cooper	cooper
ulmer	ulmer
schubert	schubert
brigitte	brigitte
barry	barry
other	other
patent	brevetto
knochen	osso
ack	ack
veb	veb
posen	pose
rechtlich	giuridicamente
wenzel	wenzel
pionier	pioniere
type	type
metz	metz
harold	harold
brothers	brothers
lebenslauf	cv
sorgt	provvede
alkohol	alcol
gene	gene
gene	geni
silva	silva
bemerkenswert	notevole
produzieren	produrre
ehre	onore
toll	stupendo
vorwort	prefazione
tropischen	tropicale
miami	miami
shanghai	shanghai
vertretung	rappresentanza
abriss	demolizione
protokoll	verbale
protokoll	protocollo
athleten	atleti
lahn	lahn
baker	baker
ethnischen	etnica
copa	copa
final	final
udo	udo
natural	natural
división	división
prinzipien	principi
ausgehend	partendo
dienstleistungen	servizi
basketballspieler	cestista
subsp	subsp
hansen	hansen
catherine	catherine
philologe	filologo
aufteilung	frazionamento
aufteilung	ripartizione
erwachsene	adulti
werfen	gettare
erfunden	inventato
mexikanischen	messicano
dicke	spessore
bodensee	bodensee
han	han
vielfalt	diversità
wettbewerbe	concorsi
heiraten	sposarsi
murray	murray
archäologe	archeologo
austin	austin
zelle	cella
wälder	boschi
schließung	chiusura
indian	indian
maßnahme	misura
chief	chief
echo	echo
kunsthalle	kunsthalle
rüdiger	rüdiger
professoren	professori
geschmack	sapore
porto	oporto
konzentration	concentrazione
interviews	interviste
wiedervereinigung	riunificazione
kabel	cavi
have	have
keramik	ceramica
bismarck	bismarck
monika	monika
flensburg	flensburg
pakistan	pakistan
grant	grant
brasilianischen	brasiliano
löwe	leone
gerechtfertigt	giustificato
pädagogik	pedagogia
melodie	melodia
canadian	canadian
beratung	consulenza
african	african
boeing	boeing
beschäftigung	occupazione
mängel	difetti
mängel	carenze
medal	medal
challenge	challenge
salvador	salvador
saarland	saarland
dakota	dakota
rache	vendetta
dutzend	dozzina
egon	egon
utrecht	utrecht
kategorisierung	categorizzazione
tiger	tigre
finanziell	finanziariamente
beamter	funzionario
allgemeines	generalità
lichtenberg	lichtenberg
eingenommen	assunto
wang	wang
liverpool	liverpool
ringer	ringer
identifiziert	identificato
behauptungen	affermazioni
roll	roll
broadway	broadway
jason	jason
alaska	alaska
soul	soul
matthew	matthew
positiven	positivi
floh	pulce
helene	helene
vogt	vogt
angela	angela
source	source
syn	syn
ruprecht	ruprecht
religionen	religioni
romanische	romanica
head	head
leonard	leonard
disney	disney
helm	casco
ruinen	rovine
offenbach	offenbach
sky	sky
köhler	köhler
externen	esterno
vision	visione
jorge	jorge
kilogramm	chilogrammi
kilogramm	chilogrammo
messung	misurazione
bassist	bassista
schwert	spada
elsass	alsazia
phoenix	phoenix
nature	nature
eisenach	eisenach
gewerkschaft	sindacato
touristen	turisti
oregon	oregon
agentur	agenzia
age	age
schreiber	schreiber
blüte	fioritura
durchgesetzt	prevalso
punk	punk
digitalen	digitale
joan	joan
bremerhaven	bremerhaven
tabellen	tabelle
überprüft	controllato
überprüft	verificato
wahlperiode	legislatura
einladung	invito
slowenien	slovenia
disziplinen	discipline
gesungen	cantato
jerry	jerry
türken	turchi
hawaii	hawaii
jules	jules
jährlichen	annuale
mine	miniera
überleben	sopravvivenza
école	école
stimmung	umore
anpassung	personalizzazione
anpassung	adattamento
entwickler	sviluppatore
schwedisch	svedese
under	under
tausende	migliaia
anwesenheit	presenze
anwesenheit	presenza
freude	gioia
prototyp	prototipo
rotterdam	rotterdam
gletscher	ghiacciaio
erzähler	narratore
operationen	operazioni
haute	haute
homburg	homburg
montana	montana
wayne	wayne
dessau	dessau
erobert	conquistato
klöster	monasteri
kaiserin	imperatrice
meier	meier
soundtrack	soundtrack
morris	morris
größen	taglie
dnb	dnb
öffnung	apertura
petra	petra
lebensmittel	alimenti
geometrie	geometria
now	now
zerstörer	distruttore
wright	wright
sergei	sergei
sergei	sergej
movie	movie
bonner	bonner
wohnsitz	residenza
independent	independent
alpha	alpha
alpha	alfa
studiert	studia
rheinischen	renano
berkeley	berkeley
illustrationen	illustrazioni
richtungen	direzioni
schnee	neve
gerald	gerald
angel	angel
vorgeschichte	preistoria
hartmut	hartmut
funk	funk
herrmann	herrmann
troll	troll
mythos	mito
schumacher	schumacher
hochladen	caricamento
sin	sin
begangen	commesso
ansätze	approcci
designer	designer
wirft	getta
wirft	solleva
verstand	intelletto
türen	porte
valentin	valentin
brandt	brandt
oklahoma	oklahoma
ignoriert	ignorato
überwachung	monitoraggio
chinesisch	cinese
gerechtigkeit	giustizia
bett	letto
vorarlberg	vorarlberg
angemessen	adeguato
ortsnamen	toponomastica
dynamo	dinamo
drehen	girare
venezuela	venezuela
experiment	esperimento
astronom	astronomo
nina	nina
ingrid	ingrid
krüger	krüger
gerichtet	rivolto
umwandlung	conversione
rosenberg	rosenberg
chaos	caos
xaver	xaver
zoo	zoo
bezahlt	pagato
cornelius	cornelio
bobby	bobby
imo	imo
gem	gem
weihnachten	natale
laien	profano
dekan	decano
russen	russi
allee	viale
basilika	basilica
zyklus	ciclo
konzepte	concetti
ndr	ndr
garcía	garcía
beibehalten	mantieni
orleans	orleans
österreicher	austriaco
österreicher	austriaci
eddie	eddie
vorbereitet	preparato
landschaften	paesaggi
years	years
baltimore	baltimore
mund	bocca
berthold	berthold
löst	scioglie
löst	risolve
xiv	xiv
reformen	riforme
sklaven	schiavi
weinbau	viticoltura
griechen	greci
individuelle	individuale
fair	fair
spitzen	punte
mohammed	mohammed
arkansas	arkansas
indonesien	indonesia
reagieren	reagire
bedingung	condizione
paolo	paolo
tagebuch	diario
ethik	etica
entdecken	scoprire
gestapo	gestapo
beginnend	iniziando
lit	lit
marshall	marshall
most	most
houston	houston
adrian	adrian
reichlich	abbondante
prize	prize
kaffee	caffè
agent	agente
zagreb	zagabria
coast	coast
nations	nations
verbesserungen	miglioramenti
grey	grey
krakau	cracovia
gedenken	commemorare
zypern	cipro
jeff	jeff
geezer	geezer
zwang	coercizione
unterart	sottospecie
komplexe	complessi
verbündeten	alleati
verbündeten	alleato
our	our
truppe	truppa
türme	torri
hut	cappello
abgeschafft	abolita
milch	latte
jon	jon
schmitt	schmitt
hills	hills
beeinflussen	influenzare
meilen	miglia
farm	fattoria
wta	wta
drum	drum
gera	gera
motorrad	moto
peer	peer
wellen	onde
car	car
philosophische	filosofico
klassiker	classico
burgund	borgogna
partnerschaft	partenariato
erfordert	richiede
pauli	pauli
brot	pane
xiii	xiii
lehren	insegnare
marseille	marsiglia
hugh	hugh
erlebt	sperimentato
chen	chen
leon	leon
french	french
duden	duden
beethoven	beethoven
mönche	monaci
krefeld	krefeld
tommy	tommy
ungarisch	ungherese
rgb	rgb
tool	tool
görlitz	görlitz
glatt	liscio
beantworten	rispondere
erwerb	acquisizione
run	run
anime	anime
kairo	cairo
haltestelle	fermata
bittet	chiede
olaf	olaf
bewusstsein	consapevolezza
erlauben	permetti
porträts	ritratti
avenue	avenue
let	let
kunstverein	kunstverein
small	small
schumann	schumann
remix	remix
trikot	maglia
lorenzo	lorenzo
renate	renate
masters	masters
tschechisch	ceco
angebote	offerte
zugewiesen	assegnato
reifen	pneumatici
wolfram	tungsteno
roberts	roberts
hirsch	cervo
augsburger	augsburger
speicher	memoria
nancy	nancy
hunter	hunter
get	get
krieger	guerriero
umstände	circostanze
eichstätt	eichstätt
eastern	eastern
delta	delta
armin	armin
brockhaus	brockhaus
ivan	ivan
konzentriert	concentrato
edwin	edwin
kent	kent
bond	bond
aluminium	alluminio
dimension	dimensione
schönheit	bellezza
sauerstoff	ossigeno
mitchell	mitchell
marion	marion
rasse	razza
schwarzwald	schwarzwald
ingolstadt	ingolstadt
zähne	denti
basierend	ignobile
problematik	problematica
cottbus	cottbus
gültig	valido
sri	sri
systematische	sistematico
denkbar	concepibile
satelliten	satelliti
umgehen	aggirare
symbole	simboli
theo	theo
medaillen	medaglie
abbruch	demolizione
spannungen	tensioni
bricht	spezza
sony	sony
verarbeitung	trasformazione
verarbeitung	lavorazione
empfohlen	consigliato
bundesautobahn	bundesautobahn
five	five
frühling	primavera
raf	raf
akzeptieren	accettare
gräber	tombe
ansbach	ansbach
collins	collins
übersehen	trascurato
analysis	analysis
terry	terry
gleichung	equazione
sockel	piedistallo
sockel	zoccolo
mögen	gradire
schulze	schulze
traditionen	tradizioni
dehio	alghisi
six	six
flag	flag
hunde	cani
krebs	cancro
virus	virus
girls	girls
energy	energy
unit	unit
fett	grasso
anzeigen	annunci
alain	alain
blättern	curiosare
wiederholen	ripetere
reformierte	riformato
historique	historique
astronomie	astronomia
decke	coperta
achim	achim
wohnt	abita
wachsenden	crescenti
michail	michail
linden	linden
globe	globe
ulrike	ulrike
nicholas	nicholas
schnabel	becco
palästina	palestina
klärung	chiarificazione
klärung	chiarimento
wilfried	wilfried
angewandt	applicato
eingeleitet	varato
beobachter	osservatore
beobachter	osservatori
medical	medical
indirekt	indiretto
indirekt	indirettamente
mtv	mtv
alias	alias
bestätigung	conferma
mühlen	mulini
wiederherstellen	ripristina
massaker	massacro
suffix	suffisso
rudolph	rudolph
woman	woman
matrix	matrice
ähnlichkeit	somiglianza
empfehlung	raccomandazione
bedrohung	minaccia
landung	atterraggio
dallas	dallas
offensive	offensiva
pole	pole
herman	herman
besiegt	sconfitto
krause	krause
entwürfe	bozze
schwimmen	nuoto
early	early
abkürzungen	abbreviazioni
protest	protesta
listet	elenca
messina	messina
bsg	zps
kosovo	kosovo
delegation	delegazione
färbung	colorazione
trophy	trophy
water	water
pest	peste
genehmigt	approvato
universum	universo
gespräche	conversazioni
biathlon	biathlon
wärme	calore
ordentlichen	ordinario
kommerzielle	commerciale
korrigieren	correggere
mechanische	meccanici
moor	moor
erfüllung	adempimento
schach	scacchi
ward	ward
breitengrad	latitudine
commonwealth	commonwealth
hohenzollern	hohenzollern
malta	malta
sitzung	seduta
bolivien	bolivia
wood	wood
seoul	seoul
aufsatz	torretta
leiche	cadavere
warner	warner
lernt	imparate
verträge	contratti
abschied	addio
perfekt	perfetto
kommunisten	comunisti
ngc	ngc
definieren	definire
augustin	augustin
gotischen	gotico
organ	organo
mineral	minerale
work	work
holger	holger
kommissar	commissario
dream	dream
grammatik	grammatica
lustig	divertente
landshut	landshut
silver	silver
upper	upper
filter	filtro
filter	filtri
hölle	inferno
beat	beat
meta	meta
charakteristisch	caratteristico
befreien	liberare
amateur	amatoriale
popularität	popolarità
oberhausen	oberhausen
laurent	laurent
wolfenbüttel	wolfenbüttel
rechtsprechung	giurisprudenza
bakterien	batteri
martha	martha
pan	pan
übersetzen	tradurre
aufbewahrt	conservata
erhard	erhard
hunderte	centinaia
kings	kings
taunus	taunus
damm	diga
genua	genova
hours	hours
gleis	binario
cook	cook
juristen	giuristi
rum	rum
warren	warren
erzählen	raccontare
nigeria	nigeria
its	its
orient	orient
schwäbischen	svevi
gespeichert	salvato
christiane	christiane
bezirke	distretti
paare	coppie
blood	blood
set	set
rechtfertigen	giustificare
administratoren	amministratori
gelernt	imparato
gefüllt	riempito
auslegung	interpretazione
haushalt	bilancio
marschall	maresciallo
prediger	predicatore
installation	installazione
kaspar	kaspar
speichern	salva
freundlich	amichevole
gehäuse	alloggiamento
zylinder	cilindro
vorschlagen	suggerisci
portugiesisch	portoghese
wähler	votanti
reduzieren	ridurre
days	days
village	village
nachteil	svantaggio
gramm	grammo
gramm	grammi
gliedert	articola
wände	pareti
begleitung	accompagnamento
wiederholte	ripetuto
wiederholte	rivisto
landesliga	landesliga
stören	disturbare
denkt	pensa
kämpfer	combattente
charlottenburg	charlottenburg
blumen	fiori
wünschen	desiderare
venus	venere
schema	schema
alexandra	alexandra
split	spalato
unruhen	disordini
keith	keith
beigetragen	contribuito
fis	fis
renommierten	prestigioso
tante	zia
einstellungen	impostazioni
dekanat	decanato
tennisspieler	tennista
selbständig	autonomo
wohn	residenziale
meisterin	campionessa
nazi	nazista
pfarrhaus	canonica
hudson	hudson
fdl	fdl
diktatur	dittatura
nase	naso
ebert	ebert
finanzen	finanza
jungfrau	vergine
fresken	affreschi
brooklyn	brooklyn
verbandsgemeinde	verbandsgemeinde
tel	tel
herder	herder
doppelte	doppio
eiförmig	ovoidale
heine	heine
kong	kong
achtung	attenzione
salon	salone
buddhismus	buddismo
zufall	coincidenza
jay	jay
suite	suite
massive	massive
massive	massiccio
salz	sale
guillaume	guillaume
export	esportazione
swr	cfa
naval	naval
helen	helen
railroad	railroad
normandie	normandia
larry	larry
ghana	ghana
entnehmen	prelevare
yale	yale
find	find
richten	rivolgere
there	there
regierungen	governi
wilden	selvaggio
deep	deep
manhattan	manhattan
volleyball	pallavolo
friedrichs	friedrichs
urlaub	vacanze
plural	plurale
baptiste	baptiste
julie	julie
oldid	oldid
inspiriert	ispirato
rafael	rafael
metro	metro
feind	nemico
klage	ricorso
schauspielhaus	schauspielhaus
fortschritt	progresso
untersuchte	esaminato
dachau	dachau
sms	sms
anatomie	anatomia
strauss	strauss
raketen	missili
steuer	tassa
steuer	imposta
bull	bull
local	local
irene	irene
aussterben	estinzione
perry	perry
aufgeben	mollare
aufgeben	rinunciare
vermieden	evitato
amtlichen	ufficiali
montag	lunedì
kurve	curva
rettung	salvataggio
fotografiert	fotografato
ems	ems
empfänger	destinatario
iucn	iucn
konsequent	coerentemente
konsequent	coerente
edith	edith
gewerkschaften	sindacati
beton	calcestruzzo
playoffs	playoff
jünger	discepolo
bois	bois
glücklich	felice
demokraten	democratici
rakete	razzo
ausgleich	compensazione
wallace	wallace
unverständlich	incomprensibile
abschaffung	abolizione
helena	helena
unterhalten	intrattenere
anwesend	presenti
moses	mosè
singapur	singapore
pablo	pablo
baut	costruisce
mülheim	mülheim
toulouse	tolosa
neunten	nono
muslime	musulmani
heyne	heyne
angeblichen	presunto
tatsächlichen	effettivo
miles	miles
christlich	cristiano
ellen	ellen
fell	pelo
zitate	citazioni
arno	arno
bemerkungen	osservazioni
cleveland	cleveland
santos	santos
gefangene	prigionieri
geiger	geiger
freud	freud
minor	minor
god	god
situationen	situazioni
piper	piper
algerien	algeria
kanzler	cancelliere
provence	provenza
jülich	jülich
kanonen	cannoni
streitigkeiten	controversie
kenneth	kenneth
newton	newton
katastrophe	disastro
mdb	mdb
formulierungen	formulazioni
summer	summer
lords	lords
neutralität	neutralità
after	after
ignaz	ignaz
true	true
quartett	quartetto
flandern	fiandre
bristol	bristol
waldeck	waldeck
namibia	namibia
political	political
verteilen	distribuire
univ	univ
salomon	salomon
greifen	afferrare
erika	erika
haase	haase
but	but
atlantik	atlantico
pont	pont
une	une
zusammenbruch	collasso
zusammenbruch	crollo
marina	marina
dans	dans
gehalt	stipendio
sauber	pulito
when	when
flöte	flauto
düren	düren
forstwirtschaft	silvicoltura
ideologie	ideologia
herzogin	duchessa
metropolitan	metropolitan
harrison	harrison
dietmar	dietmar
diana	diana
handschrift	calligrafia
nazis	nazisti
ron	ron
landwirt	agricoltore
heilig	sacro
sorge	preoccupazione
malaysia	malesia
augustus	augustus
strahlung	radiazione
strahlung	radiazioni
aufsehen	scalpore
eintragung	iscrizione
vera	vera
internen	interni
alexandria	alessandria
ergänzungen	supplementi
psychiatrie	psichiatria
ohren	orecchie
trennt	separa
bush	bush
bordeaux	bordeaux
elite	elite
ostfriesland	ostfriesland
realen	reale
elias	elias
astronomen	astronomi
abwesenheit	assenza
bibliographie	bibliografia
rallye	rally
willkommen	benvenuto
willkommen	benvenuti
abb	abb
kraus	kraus
einstein	einstein
motivation	motivazione
faz	faz
ungeeignet	inadeguato
apostel	apostoli
amphoe	amphoe
spalten	colonne
wolfsburg	wolfsburg
singer	singer
widmen	dedicare
aufsicht	supervisione
middle	middle
ausgegeben	speso
ausgegeben	spesi
gewährt	concesso
eurovision	eurovision
gutachten	perizie
gutachten	perizia
bock	bock
winkler	winkler
match	match
erneuerung	rinnovo
firefox	firefox
colin	colin
phasen	fasi
kombiniert	combinato
brecht	brecht
olga	olga
italiener	italiani
industrielle	industriale
het	het
gezeichnet	disegnato
atlantic	atlantic
steffen	steffen
anhang	allegato
schulden	debito
barth	barth
naturforscher	naturalista
nebel	nebbia
carmen	carmen
ffffff	ffffff
codex	codex
kommunalen	comunale
turniere	tornei
gesichtet	avvistato
león	león
caesar	cesare
hedwig	edvige
trennte	separava
susan	susan
exemplar	esemplare
veit	veit
unrecht	torto
treppe	scale
songwriter	cantautore
diplomatischen	diplomatico
winterthur	winterthur
oberpfalz	oberpfalz
holmes	holmes
dramatiker	drammaturgo
antisemitismus	antisemitismo
restaurants	ristoranti
kantone	cantoni
heck	heck
hardware	hardware
stolz	fiero
leverkusen	leverkusen
göttin	dea
electric	electric
mittelfeld	centrocampo
schweigen	silenzi
helga	helga
instanz	istanza
geologe	geologo
witz	scherzo
munition	munizioni
aschaffenburg	aschaffenburg
vegas	vegas
neil	neil
kramer	kramer
utah	utah
trek	trek
brett	brett
unterhaltung	intrattenimento
allan	allan
gutenberg	gutenberg
kontinent	continente
castro	castro
götz	götz
happy	happy
föderation	federazione
widmet	dedica
haas	haas
symptome	sintomi
hopkins	hopkins
unwahrscheinlich	improbabile
jahn	jahn
nfl	nfl
species	species
rohr	tubo
danny	danny
maier	maier
dean	dean
ringe	anelli
children	children
sort	sort
ausgedrückt	espresso
zell	zell
albanien	albania
durchzusetzen	imporre
unterzeichnet	firmato
alexandre	alexandre
toni	toni
emden	emden
schlachten	battaglie
marmor	marmo
kant	kant
katze	gatto
brd	brd
judith	judith
erweiterungen	estensioni
adalbert	adalbert
sternbild	costellazione
bedeutungen	significati
monster	mostri
call	call
betreffen	riguardare
landau	landau
statistiken	statistiche
works	works
pos	pos
liberal	liberale
march	march
paula	paula
alb	alb
hampshire	hampshire
landen	atterrare
stanford	stanford
historia	historia
senioren	anziani
imdb	imdb
rudi	rudi
ludwigshafen	ludwigshafen
limited	limited
höhlen	grotte
äthiopien	etiopia
birmingham	birmingham
anfragen	richieste
kopieren	copiare
waldemar	waldemar
gestanden	confessato
verstärkte	rafforzata
zucker	zucchero
ida	ida
winfried	winfried
byzantinischen	bizantina
singt	canta
beliebig	qualsiasi
dargelegt	illustrato
erlassen	emanare
gisela	gisela
short	short
sigmund	sigmund
gelebt	vissuto
société	société
haare	capelli
budget	budget
nicole	nicole
transkription	trascrizione
lucius	lucio
congress	congress
abzug	detrazione
circle	circle
zwickau	zwickau
getreide	cereali
sigismund	sigismund
fpö	fpö
sozialismus	socialismo
temple	temple
doris	doris
fehlte	mancava
sexuelle	sessuale
perspektiven	prospettive
madison	madison
revert	revert
magic	magic
respekt	rispetto
zentren	centri
tambon	tambon
büros	uffici
deportiert	deportato
rundschau	rundschau
protestantischen	protestante
synchronsprecher	doppiatore
alpes	alpes
joint	joint
oma	nonna
only	only
audi	audi
tipp	suggerimento
tödlich	letale
freiburger	freiburger
geworfen	gettato
zufrieden	soddisfatto
widerspricht	contraddice
veraltet	obsoleti
veraltet	obsoleto
bozen	bolzano
butler	maggiordomo
knight	knight
ethnien	etnie
vegetation	vegetazione
gehirn	cervello
born	born
primera	primera
empfehlen	raccomandare
armstrong	armstrong
into	into
dauern	durare
isaac	isaac
ludwigsburg	ludwigsburg
humor	umorismo
meiningen	meiningen
emmy	emmy
hannes	hannes
kessel	caldaie
messer	coltello
brt	tsl
legion	legione
ergo	ergo
aristoteles	aristotele
gladbach	gladbach
expansion	espansione
sakristei	sacrestia
side	side
schlag	colpo
industrialisierung	industrializzazione
igor	igor
par	par
freising	freising
zensur	censura
nachteile	svantaggi
dreieck	triangolo
gepflegt	curato
intelligenz	intelligenza
pol	pol
entkommen	sfuggire
mediawiki	mediawiki
experte	esperto
pmid	pmid
warte	aspetta
skandal	scandalo
publications	publications
bauch	pancia
fördert	promuove
logos	loghi
mächtigen	potenti
blockiert	bloccato
steigen	salire
low	low
seattle	seattle
grundsatz	principio
fünfter	quinto
fächer	ventaglio
apsis	abside
bio	bio
begeistert	entusiasta
theologen	teologi
arbeitnehmer	lavoratori
watson	watson
their	their
iris	iris
burgenland	burgenland
quedlinburg	quedlinburg
seltsam	strano
überzeugung	persuasione
überzeugung	convinzione
gasse	vicolo
bergisch	bergisch
nannten	chiamavano
treu	fedele
nachdenken	riflettere
kunststoff	plastica
angebliche	presunta
folk	folk
erwartungen	aspettative
werkzeug	attrezzo
tauchen	immersioni
ibm	ibm
sophia	sophia
know	know
unvollständig	incompleta
unvollständig	incompleto
umstellung	riconversione
georgien	georgia
zerstören	distruggere
spitznamen	soprannomi
illustrator	illustratore
anschlag	attentato
heimlich	segretamente
verletzte	feriti
tus	tus
tempo	ritmo
statistisch	statisticamente
verbracht	trascorso
reinhardt	reinhardt
square	square
getestet	testato
getriebe	attrezzi
queensland	queensland
moser	moser
dietz	dietz
jeanne	jeanne
herzegowina	erzegovina
secret	secret
hinzufügen	aggiungi
trade	trade
statuen	statue
experimente	esperimenti
armut	povertà
libanon	libano
lieutenant	tenente
unbrauchbar	inutilizzabile
organisieren	organizzare
dänisch	danese
betrag	importo
mathilde	mathilde
freiberg	freiberg
blind	cieco
publishers	publishers
césar	césar
mohr	mohr
böhlau	böhlau
gonzález	gonzález
leidenschaft	passione
thriller	thriller
gitarristen	chitarristi
leiten	dirigere
eifel	eifel
amadeus	amadeus
marien	marien
verhältnismäßig	proporzionato
tell	tell
opel	opel
linda	linda
rita	rita
martina	martina
aue	aue
brechen	rompere
isabella	isabella
arnsberg	arnsberg
künstliche	artificiale
motorsport	motorsport
ernähren	nutrire
trust	trust
pays	pays
müll	spazzatura
honda	honda
palermo	palermo
handwerker	artigiano
verwandtschaft	parentela
beute	bottino
kompromiss	compromesso
veranstalter	organizzatore
veranstalter	organizzatori
rechtschreibung	ortografia
panorama	panorama
rechtzeitig	tempestivo
moral	morale
tallinn	tallinn
never	never
judentum	giudaismo
romeo	romeo
kasachstan	kazakistan
nils	nils
scottish	scottish
überlebt	sopravvissuto
geistigen	intellettuale
märtyrer	martiri
märtyrer	martire
explosion	esplosione
theoretischen	teorico
larven	larve
rangers	rangers
drogen	droghe
arabisch	arabo
kurse	corsi
bautzen	bautzen
terror	terrore
rhône	rodano
soziologe	sociologo
tibet	tibet
homo	homo
territorien	territori
ewald	ewald
untersuchen	indagare
jefferson	jefferson
algebra	algebra
pascal	pascal
homosexualität	omosessualità
zeuge	testimone
hope	hope
billboard	billboard
bowl	bowl
edwards	edwards
jenny	jenny
birgit	birgit
korrektur	correzione
holt	holt
telekom	telekom
ideal	ideale
communes	communes
tff	tff
spencer	spencer
hardy	hardy
unsicher	incerto
äbtissin	badessa
angestellte	impiegati
ram	ram
kleve	kleve
verkürzt	abbreviato
olivier	olivier
schmuck	gioielleria
innovation	innovazione
werder	werder
craig	craig
académie	académie
zivilen	civile
sammelt	raccoglie
einheitlichen	unificato
dumont	dumont
altona	altona
steinbruch	cava
mähren	moravia
häfen	porti
entschuldigung	scuse
editor	editor
alessandro	alessandro
mix	mix
gfdl	gfdl
aka	aka
umfrage	sondaggio
else	else
jennifer	jennifer
schilling	scellino
allgäu	allgäu
sandra	sandra
cannes	cannes
tänzerin	ballerina
anklage	imputazione
anklage	accusa
weiden	pascoli
lettland	lettonia
sammler	collezionisti
aktualisiert	aggiornato
etappen	tappe
apollo	apollo
sudan	sudan
mut	coraggio
achsen	assi
enterprise	enterprise
stützen	montanti
lüttich	liegi
algorithmus	algoritmo
einhaltung	osservanza
einhaltung	conformità
uno	onu
étienne	étienne
cars	cars
watt	watt
balthasar	balthasar
reis	riso
bär	orso
slam	slam
gert	gert
ecuador	ecuador
ilse	ilse
rosenheim	rosenheim
trinken	bere
potter	potter
pazifik	pacifico
duell	duello
elektrotechnik	elettrotecnica
limes	limes
verschwindet	scompare
verringert	diminuisce
zahlung	pagamento
bergmann	minatore
nathan	nathan
ausländer	stranieri
spitz	spitz
guatemala	guatemala
portland	portland
spam	spam
annette	annette
introduction	introduction
theresia	theresia
rico	rico
willem	willem
leonardo	leonardo
flash	flash
havel	havel
civil	civil
verbringen	trascorrere
verdienen	guadagnare
view	view
messungen	misurazioni
vergabe	aggiudicazione
seven	seven
komm	vieni
risiken	rischi
markgrafen	margravio
herzöge	duchi
konzeption	concezione
beleidigung	insulto
simone	simone
rügen	rügen
take	take
datierung	datazione
inter	inter
bratislava	bratislava
scotland	scotland
potok	potok
ming	ming
grace	grace
elektronen	elettroni
mosel	mosel
vereinbart	concordato
vereinbart	convenuto
stuhl	sedia
beweise	prove
neuhaus	neuhaus
magister	magister
republikaner	repubblicani
doctor	doctor
mar	mar
minderheiten	minoranze
einschränkungen	limitazioni
nützlich	utile
wiedergewählt	rieletto
lambert	lambert
lima	lima
dog	dog
geschossen	sparato
modernisierung	ammodernamento
modernisierung	modernizzazione
angeklagt	accusato
