snails	ốc
snails	snails
martínez	martínez
mercer	mercer
crimson	crimson
dominion	dominion
medley	medley
porn	porn
mirrors	gương
mirrors	mirrors
remnants	remnants
vegetables	rau
leningrad	leningrad
laos	lào
wiltshire	wiltshire
ant	kiến
curling	curling
fits	fits
fits	hợp
fits	khớp
rotten	thúi
fernández	fernández
fury	fury
bihar	bihar
kraków	krakow
suzuki	suzuki
mobility	mobility
fascist	nazi
registry	registry
catches	catches
olivier	olivier
randall	randall
aligned	aligned
dunn	dunn
chandler	chandler
spur	spur
laurence	laurence
verde	verde
curved	cong
reilly	reilly
inheritance	inheritance
prodcode	prodcode
cease	ngừng
ugly	xấu
ugly	xau
ugly	xí
rivera	rivera
lineage	lineage
guam	guam
zhou	chu
mir	mir
avant	avant
turbine	turbine
outlet	outlet
eduardo	eduardo
vince	vince
mint	mint
brotherhood	brotherhood
iconic	iconic
katie	katie
bizarre	bizarre
ign	ign
swansea	swansea
slip	trượt
shri	shri
gore	gore
herb	herb
rep	rep
stripped	stripped
crescent	crescent
genome	genome
hale	hale
sonny	sonny
jonas	jonas
hawkins	hawkins
sheets	tờ
sheets	mẩu
sheets	sheets
debutdate	debutdate
winters	winters
cds	cd
casa	casa
tricks	tricks
burlington	burlington
confined	confined
salvation	salvation
swamp	lầy
hanna	hanna
dove	dove
jennings	jennings
sutherland	sutherland
suspects	nghi
staffordshire	staffordshire
müller	müller
müller	muller
bremen	bremen
benny	benny
stafford	stafford
stephens	stephens
xiii	xiii
racer	racer
comeback	comeback
precious	precious
precious	quý
dei	dei
aging	aging
garrett	garrett
broadcasters	broadcasters
wan	wan
christchurch	christchurch
spiral	spiral
marcos	marcos
admiralty	admiralty
madame	madame
miniseries	miniseries
luigi	luigi
ieee	ieee
numbering	numbering
café	café
hare	lepus
hare	hare
correction	sửa
jensen	jensen
crusade	crusade
talbot	talbot
brooke	brooke
cube	cube
cube	rubik
goa	goa
vacation	nghỉ
maggie	maggie
boots	giày
boots	bốt
boots	ủng
boots	boots
ligue	ligue
byrne	byrne
luna	luna
flint	flint
kurdish	kurd
lawn	lawn
weaver	ploceus
weaver	weaver
mai	mai
einstein	einstein
forgot	quên
gould	gould
livingston	livingston
titular	titular
niagara	niagara
demons	quỷ
sinking	chìm
vintage	vintage
perkins	perkins
gdp	gdp
pius	piô
pius	pius
stereo	stereo
tina	tina
resume	cv
resume	resume
molly	molly
robbie	robbie
thoroughbred	thoroughbred
mans	mans
neighbors	xóm
rim	rim
assam	assam
wendy	wendy
gran	gran
feud	feud
jockey	jockey
breathing	thở
alison	alison
niger	niger
emmanuel	emmanuel
doll	doll
oaks	oaks
oaks	sồi
umbrella	umbrella
elliot	elliot
bahá	bahá
edith	edith
berg	berg
paula	paula
sink	cạn
prop	prop
hiking	hiking
mansfield	mansfield
rama	rama
afb	afb
violet	violet
northampton	northampton
wordpress	wordpress
constable	constable
loneos	loneos
cosmic	cosmic
shawn	shawn
piper	piper
definite	definite
bullets	đạn
holden	holden
lionel	lionel
daniels	daniels
drinks	uống
prosecutor	tố
bollywood	bollywood
irene	irene
chamberlain	chamberlain
dive	lặn
sworn	thề
anita	anita
apartheid	apartheid
ada	ada
reject	huỷ
abbott	abbott
stephanie	stephanie
mack	mack
lucia	lucia
smile	smile
smile	cười
injection	tiêm
calcium	calcium
calcium	canxi
jill	jill
sophia	sofia
sophia	sophia
swords	gươm
swords	kiếm
pokémon	pokémon
pokémon	pokemon
buchanan	buchanan
sant	sant
horace	horace
darker	darker
emerson	emerson
mandarin	mandarin
mandarin	quýt
garde	garde
borrowed	mượn
vaughan	vaughan
discourse	discourse
rajasthan	rajasthan
collar	collar
honolulu	honolulu
fcc	fcc
contribs	contribs
sunny	nắng
sunny	sunny
jakarta	jakarta
natalie	natalie
chin	chin
chin	cằm
lester	lester
macau	macao
macau	macau
barbados	barbados
activism	activism
twilight	twilight
lowe	lowe
nitrogen	nitơ
nitrogen	nitrogen
sergei	sergei
kirby	kirby
displaced	displaced
firefox	firefox
leonardo	leonardo
irc	irc
brittany	bretagne
brittany	brittany
una	una
contributes	contributes
lobby	sảnh
minorities	minorities
rollbacker	rollbacker
bean	bean
bean	đậu
blades	blades
nyc	nyc
pitt	pitt
printer	viết
genoa	genoa
genoa	genova
brandenburg	brandenburg
residences	residences
thumb	thumb
wikipedian	wikipedian
mediawiki	mediawiki
lublin	lublin
isabel	isabel
sol	sol
luftwaffe	luftwaffe
overnight	overnight
marty	marty
segunda	segunda
kerr	kerr
butterflies	bướm
lennon	lennon
fowler	fowler
labs	labs
instructed	dặn
casual	casual
rude	rude
soup	soup
soup	súp
soup	cháo
loch	hồ
dissertation	dissertation
python	python
python	trăn
throat	họng
finn	tìm
finn	finn
mound	mound
mound	gò
mozambique	mozambique
uzbekistan	uzbekistan
stained	thoa
punjabi	punjabi
caste	caste
stirling	stirling
senegal	senegal
beirut	beirut
wildcats	wildcats
deposit	deposit
olivia	olivia
colombo	colombo
observers	observers
hubert	hubert
basil	basil
batch	đợt
batch	batch
batch	mẻ
batch	bó
greenwood	greenwood
breath	thở
baton	gậy
baton	baton
spokesman	spokesman
meadows	meadows
turnout	turnout
aluminum	nhôm
stein	stein
jokes	đùa
bark	sủa
bark	bark
flickr	flickr
tenants	tenants
conscious	conscious
alley	ngõ
alley	alley
alley	hẻm
schneider	schneider
bert	bert
bowie	bowie
geo	geo
meditation	thiền
smalltext	smalltext
rue	rue
critique	critique
browne	browne
liz	liz
horns	sừng
canceled	hủy
taxation	thuế
miniature	miniature
dartmouth	dartmouth
clarity	clarity
forewings	forewings
chevrolet	chevrolet
void	void
cab	taxi
cab	cab
cab	xi
yearsactive	yearsactive
increment	increment
tumor	bướu
torah	torah
catalonia	catalunya
catalonia	catalonia
cricinfo	cricinfo
geoff	geoff
jimbo	jimbo
bees	ong
vanderbilt	vanderbilt
equilibrium	equilibrium
realism	realism
adaptations	adaptations
johannesburg	johannesburg
bent	bent
becker	becker
humorous	hài
shores	shores
hoffman	hoffman
chung	chung
juniors	nhí
oman	oman
flank	sườn
okinawa	okinawa
helmet	mũ
straw	rơm
tens	chục
steele	steele
goodman	goodman
havana	havana
messenger	messenger
robbery	cướp
ducks	vịt
castile	castilla
accessdate	accessdate
peaking	peaking
bowler	bowler
huang	hoàng
huang	huang
int	int
trauma	tổn
reyes	reyes
vols	vols
troll	troll
troll	ogre
proto	proto
proxy	proxy
coding	coding
canoe	kano
canoe	xuồng
canoe	canoe
gasoline	xăng
podcast	podcast
commuter	commuter
bloc	bloc
cpu	cpu
chord	chord
barrow	barrow
angus	angus
leinster	leinster
costumes	costumes
domingo	domingo
cowboy	cowboy
koch	koch
sts	sts
minded	minded
choral	choral
grape	nho
limerick	limerick
khorasan	khorasan
haunted	ám
haunted	haunted
marxist	marxist
aluminium	nhôm
permits	ngập
savannah	savannah
quarry	quarry
cola	cola
irvine	irvine
rbi	rbi
davenport	davenport
marseille	marseille
marseille	marseilles
gibbs	gibbs
rand	rand
sergio	sergio
appreciation	appreciation
enzymes	enzymes
awkward	awkward
spanning	spanning
dioxide	dioxide
dioxide	điôxít
geograph	geograph
theologian	theologian
receptors	receptors
donovan	donovan
hogan	hogan
nominees	nominees
ole	ole
doubled	thắt
gavin	gavin
ceylon	ceylon
depiction	depiction
converts	converts
excavations	excavations
reuters	reuters
hercules	hercules
devi	devi
sheridan	sheridan
pile	đống
pile	less
samurai	samurai
cassette	cassette
stripes	dải
juice	juice
hilton	hilton
blu	blu
giles	giles
stomach	bụng
buttons	nút
gram	gam
gram	gram
gram	grams
hinduism	hinduism
reggae	reggae
hussein	hussein
pharmacy	dược
cam	cam
dinamo	dinamo
sci	sci
contexts	contexts
cannes	cannes
willow	willow
hbo	hbo
starr	starr
statutory	statutory
winged	cánh
concurrency	concurrency
shtml	shtml
pagan	pagan
matched	khớp
crashes	crashes
pizza	pizza
evan	evan
rwanda	rwanda
mls	mls
avengers	avengers
thornton	thornton
ghosts	ghosts
ghosts	ma
xml	xml
xml	xm
colt	colt
pulitzer	pulitzer
mistress	mistress
ethnicities	ethnicities
mortar	vữa
cop	cớm
cop	cop
activation	activation
lyric	lyric
cypriot	síp
ios	ios
gale	gale
dominic	dominic
bud	nghị
bud	răn
bud	bud
melissa	melissa
skip	skip
hapoel	hapoel
invite	mời
martinez	martinez
medina	medina
frustrated	nản
engineered	chấn
arranger	arranger
infinity	infinity
cretaceous	cretaceous
bite	bit
bite	đớp
bite	táp
bite	cắn
bavarian	bavarian
marilyn	marilyn
neighbor	xóm
campeonato	campeonato
wanna	muốn
harlem	harlem
warwickshire	warwickshire
pigs	lợn
pigs	heo
centennial	centennial
joão	joão
bolt	bolt
wakefield	wakefield
infamous	infamous
damascus	damascus
hai	hải
porch	hiên
porch	porch
vhs	vhs
sioux	sioux
chu	chu
abs	abs
banning	banning
sul	sul
watt	watt
kite	diều
sylvia	sylvia
frigate	frigate
shade	râm
shade	khuất
marian	marian
coastline	coastline
clive	clive
lamp	lamp
lamp	đèn
camping	camping
chips	chips
bloom	bloom
bloom	blooms
bloom	nở
emil	emil
prayers	đậu
bruins	bruins
malik	malik
res	res
caliber	caliber
bordeaux	bordeaux
lowell	lowell
marino	marino
ruined	hỏng
ruined	xì
kidney	thận
teddy	teddy
omega	omega
cheng	trịnh
cheng	thành
cheng	cheng
sunni	sunni
outreach	outreach
ordnance	ordnance
neville	neville
brush	lĩnh
brush	chổi
alain	alain
mama	mama
ein	ein
turbo	turbo
pietro	pietro
baxter	baxter
addiction	nghiện
addiction	addiction
anders	anders
emerge	emerge
maid	maid
confluence	confluence
brake	phanh
loire	loire
jacket	jacket
spinning	spinner
spinning	spinning
brendan	brendan
scarlet	scarlet
dante	dante
gerry	gerry
granada	granada
ins	ins
boulder	boulder
amphibious	amphibious
mariners	mariners
mutant	mutant
oracle	oracle
slim	slim
slim	gầy
erosion	erosion
borneo	borneo
transformers	transformers
evelyn	evelyn
beethoven	beethoven
parole	parole
frankie	frankie
economists	economists
terra	terra
bahamas	bahamas
spark	spark
spark	bugi
kappa	kappa
potato	khoai
acc	acc
kathleen	kathleen
endless	endless
apex	apex
lil	lil
mortgage	vay
mortgage	mortgage
zur	zur
lagos	lagos
representations	representations
truman	truman
ashton	ashton
taliban	taliban
olga	olga
flyers	flyers
xiv	xiv
bubble	bubble
mauritius	mauritius
panzer	panzer
wilmington	wilmington
tempo	gear
dexter	dexter
perennial	perennial
kerman	kerman
rai	rai
api	api
hatch	hatch
unionist	unionist
snakes	rắn
nile	nile
bern	bern
daisy	daisy
authentic	thực
authentic	authentic
xvi	xvi
xvi	xvii
lawson	lawson
rupert	rupert
mccartney	mccartney
nikolai	nikolai
nikolai	nicolai
cord	cord
cobra	cobra
sensitivity	nhạy
holstein	holstein
huntington	huntington
barons	bá
enrique	enrique
roth	roth
kaiser	kaiser
judiciary	judiciary
vicente	vicente
streaming	luồng
streaming	streaming
jeanne	jeanne
klaus	klaus
anarchist	anarchist
oxide	oxit
oxide	ôxít
oxide	oxide
stella	stella
dose	liều
zombie	zombie
backwards	ngược
liberia	tuyến
liberia	liberia
blackpool	blackpool
offline	offline
userbox	userbox
norris	norris
harp	hạc
harp	harp
rental	thuê
fried	chiên
alexandre	alexandre
cyril	cyril
hertfordshire	hertfordshire
aces	aces
aces	ách
shropshire	shropshire
spiders	nhện
woo	woo
bonnie	bonnie
crack	đê
crack	nứt
incarnation	kiếp
oldham	oldham
liam	liam
mgm	mgm
everett	everett
quincy	quincy
utrecht	utrecht
volcanoes	volcanoes
britannica	britannica
threads	threads
humphrey	humphrey
peterborough	peterborough
zurich	zürich
zurich	zurich
lumpur	lumpur
wolfe	wolfe
drill	khoan
exotic	exotic
sauce	ngao
sauce	sốt
archie	archie
javier	javier
cartridge	hộp
clifton	clifton
nagar	nagar
deluxe	deluxe
deluxe	xịn
commando	commando
deportivo	deportivo
springer	springer
resurrection	resurrection
ind	ind
usb	usb
belize	be
belize	belize
prosperity	vượng
comet	comet
troubled	troubled
archibald	archibald
lava	lava
esther	esther
peel	peel
heidelberg	heidelberg
wikiprojects	wikiprojects
groove	groove
lantern	toulouse
lantern	lantern
savoy	savoy
saunders	saunders
ladder	thang
ladder	ladder
bohemia	bohemia
thief	trộm
guyana	guyana
vanessa	vanessa
halloween	halloween
appointments	hẹn
levi	levi
rodgers	rodgers
homestead	homestead
plc	plc
sainte	sainte
pune	pune
sarajevo	sarajevo
dominance	dominance
laugh	cười
lars	lars
viktor	viktor
sandwich	sandwich
toulouse	toulouse
tap	nhấn
incredibly	incredibly
cruisers	cruisers
rover	rover
exams	thi
shelley	shelley
adverse	adverse
nichols	nichols
induction	induction
trombone	trombone
trombone	kèn
airplay	airplay
edison	edison
eyed	eyed
magnet	magnet
codex	codex
wool	len
forensic	forensic
dia	dia
cornish	cornish
yuri	yuri
hiroshima	hiroshima
wash	rửa
freddie	freddie
nationale	nationale
treason	phản
babies	bé
babies	babies
wilkinson	wilkinson
leaning	leaning
ballads	ballads
pillars	đương
reginald	reginald
zhu	chu
une	une
owens	owens
lately	lately
guggenheim	guggenheim
hector	hector
lounge	lounge
presenters	presenters
sacks	sacks
tara	tara
curry	curry
goat	dê
goat	goat
nightmare	mộng
burst	mỡ
burst	burst
yokohama	yokohama
scorea	scorea
secretariat	secretariat
spans	spans
wta	wta
teens	teens
romanesque	romanesque
shake	lắc
shake	rung
elias	elias
resist	cưỡng
resist	kiềm
planetary	planetary
pseudo	pseudo
alba	alba
biodiversity	biodiversity
bluff	bluff
zhao	triệu
rogue	rogue
dolls	dolls
barney	barney
sikh	sikh
feathers	lông
richie	richie
extraction	trekking
turf	turf
expo	expo
bhutan	bhutan
esp	esp
deadline	deadline
bon	bon
exchanges	exchanges
whip	roi
whip	whip
replica	replica
smiles	cười
sympathetic	sympathetic
heinz	heinz
lizard	lằn
zen	zen
remixes	remixes
axe	rìu
axe	axe
flour	bột
jade	ngọc
insane	cuồng
fry	rán
ida	lda
ida	ida
goose	ngỗng
goose	goose
scientology	scientology
chiang	chiang
dom	dom
garbage	rác
regency	regency
fulton	fulton
sixteenth	sixteenth
riga	riga
mom	mẹ
mom	mom
hasan	hasan
mosaic	khảm
mosaic	mosaic
icc	icc
ark	hòm
ark	ark
ark	tờ
ark	mẩu
joachim	joaquim
joachim	joachim
bahn	bahn
rutgers	rutgers
comma	phết
comma	phẩy
crude	thô
crude	plump
rom	rom
caucasus	caucasus
caucasus	kavkaz
charlton	charlton
bodyclass	bodyclass
occupying	chiếm
mao	mậu
mao	mao
baptiste	baptiste
paz	paz
sid	sid
lime	vôi
lime	chanh
lime	lime
raleigh	raleigh
crossover	crossover
karate	karate
dickinson	dickinson
drought	lau
maccabi	maccabi
ajax	ajax
chargers	chargers
caucus	caucus
reconstructed	reconstructed
catcher	catcher
prev	trước
thor	tor
thor	thor
thirteenth	thirteenth
bohemian	bohemian
wichita	wichita
lottery	xổ
conan	conan
endowment	endowment
wiley	wiley
patriot	patriot
deacon	deacon
julio	julio
paso	paso
kang	kang
kang	khang
bourbon	bourbon
promoter	promoter
nineteen	nineteen
greco	greco
gable	gable
thatcher	thatcher
parma	parma
chairs	ghế
tablet	tablet
flip	lật
shelf	kệ
upright	vững
packages	gói
gong	gong
sammy	sammy
tong	tong
adobe	adobe
avon	avon
vega	vega
rosario	rosario
tko	tko
leap	leap
everton	everton
lakers	lakers
sic	sic
malawi	malawi
méxico	méxico
méxico	mêxico
noon	noon
noon	trưa
hist	hist
strauss	strauss
confession	confession
mba	mba
stunt	stunt
monopoly	monopoly
surf	surf
nathaniel	nathaniel
playboy	playboy
penguins	penguins
eisenhower	eisenhower
opus	opus
linebacker	linebacker
chatham	chatham
jewelry	sỉ
sharma	sharma
organist	organist
russo	russo
laguna	laguna
elevator	kháng
discs	discs
lenin	lenin
patience	kiên
peggy	peggy
tucson	tucson
nickel	nickel
nickel	niken
verbs	verbs
calculate	tính
maj	maj
alexis	alexis
libyan	libyan
liang	lương
liang	liang
oxfordshire	oxfordshire
townsend	townsend
tear	tear
tear	xé
subordinate	subordinate
shine	shine
sounding	sounding
violinist	violinist
ntupdate	ntupdate
botswana	botswana
deborah	deborah
leicestershire	leicestershire
promptly	gta
alejandro	alejandro
orient	orient
balkan	balkan
pascal	pascal
venetian	venetian
cum	cum
judo	judo
eli	eli
cane	hèo
cane	kho
npr	npr
croix	croix
cyber	cyber
pauline	pauline
ego	ego
hooks	hooks
nwa	nwa
mia	mia
meridian	meridian
bayern	bayern
satirical	satirical
reissued	reissued
wrapped	bọc
harriet	harriet
audition	audition
amor	amor
hubbard	hubbard
merry	merry
backgrounds	backgrounds
nottinghamshire	nottinghamshire
busch	busch
dalton	dalton
lethal	lethal
banana	chuối
banana	banana
guerrero	guerrero
usaf	usaf
friction	friction
madness	madness
routledge	routledge
mutations	mutations
assassin	assassin
histoire	histoire
harding	harding
daddy	bố
guinness	guinness
adler	adler
carpet	chăn
carpet	thảm
felipe	felipe
hamlets	hamlets
buzz	buzz
intake	intake
unhappy	lê
seventeenth	seventeenth
laden	laden
byrd	byrd
homage	homage
cooke	cooke
hulk	hulk
grandchildren	cháu
suppression	suppression
mae	mae
antony	antony
antony	antonius
natal	natal
contention	contention
unix	unix
ernie	ernie
chandra	chandra
beard	râu
beard	beard
coca	coca
concord	concord
macarthur	macarthur
tottenham	tottenham
bel	bel
worcestershire	worcestershire
danube	danube
danube	donau
garland	garland
côte	côte
bas	bas
boyle	boyle
moody	moody
beacon	beacon
coaster	coaster
baja	baja
blah	bla
blah	duyệt
blah	vân
arches	arches
hazard	hazard
titan	titan
psychedelic	psychedelic
qaeda	qaida
forrest	forrest
osborne	osborne
osborne	osbourne
somali	somali
mma	mma
reminiscent	reminiscent
libertarian	libertarian
weiss	weiss
wembley	wembley
flores	flores
enlightenment	enlightenment
fielding	fielding
gps	gps
citadel	thành
citadel	citadel
gravel	sỏi
oswald	oswald
noir	noir
myths	myths
anterior	anterior
sticks	gậy
sticks	que
sticks	dùi
zinc	kẽm
zinc	sink
zinc	zinc
zinc	zink
beans	đậu
mclean	mclean
shrewsbury	shrewsbury
ang	ang
tractor	tractor
typing	gõ
borne	borne
sting	sting
pic	pic
cents	xu
scandinavian	scandinavi
scandinavian	scandinavia
atari	atari
inlet	inlet
fairfield	fairfield
pounder	pounder
chronological	chronological
butter	bơ
float	float
float	nổi
cyrus	cyrus
laptop	laptop
spartak	spartak
derry	derry
render	vẽ
nhs	nhs
morse	morse
outfit	outfit
habsburg	habsburg
schwartz	schwartz
drain	drain
nate	nate
strasbourg	strasbourg
lemon	chanh
norte	norte
brennan	brennan
ions	ions
afro	afro
nuts	nuts
nuts	bi
por	poor
por	por
eddy	eddy
caldwell	caldwell
eco	eco
foul	foul
bentley	bentley
ankara	ankara
geelong	geelong
beaumont	beaumont
gorge	gorge
mcgill	mcgill
nolan	nolan
procession	rước
weir	weir
panther	báo
panther	panther
foremost	foremost
aragon	aragon
palermo	palermo
jaw	hàm
explores	explores
baritone	baritone
kilkenny	kilkenny
ceramic	gốm
ceramic	ceramic
pony	pony
pony	ngựa
cornelius	cornelius
moor	maori
moor	moor
abbas	abbas
collaborations	collaborations
tidal	tidal
hui	huệ
hui	hui
hui	hủi
hui	huy
panorama	panorama
mural	mural
torque	torque
hatred	hat
futsal	futsal
monumental	monumental
anaheim	anaheim
wolverhampton	wolverhampton
spire	spire
centro	centro
brakes	phanh
jays	jays
basal	basal
versa	versa
wholesale	sỉ
asphalt	nhựa
laurie	laurie
middleton	middleton
flynn	flynn
toby	toby
mole	mole
mole	talpa
nicholson	nicholson
cheaper	rẻ
piedmont	cuneo
otters	otters
patrons	patrons
sparks	sparks
berger	berger
trolling	trolling
coliseum	coliseum
aero	aero
smell	mùi
moreno	moreno
bamboo	bamboo
bamboo	tre
lockheed	lockheed
charging	sạc
dal	dal
dal	dall
foo	foo
setup	setup
navbox	navbox
lean	gầy
lean	nghiêng
sweep	quét
meredith	meredith
purdue	purdue
nissan	nissan
samantha	samantha
babylon	babylon
huddersfield	huddersfield
smash	smash
putnam	putnam
hut	hut
hut	lều
salzburg	salzburg
devised	devised
dillon	dillon
veronica	veronica
brock	brock
galicia	galicia
pal	pal
gus	gus
tiles	lát
drift	trôi
brewing	brewing
canary	serinus
canary	canary
olympia	olympia
radial	radial
córdoba	córdoba
nude	nude
feminism	feminism
transitional	transitional
waterford	waterford
shia	shia
insee	insee
willy	willy
ramsey	ramsey
metacritic	metacritic
ling	ling
ling	linh
reflections	reflections
wyatt	wyatt
cfd	cfd
shan	đan
shan	shan
depictions	depictions
minsk	minsk
chrome	chrome
scroll	cuộn
niche	niche
crap	cức
crap	hốt
lifting	nâng
lifting	lifting
doncaster	doncaster
agf	agf
wax	sáp
wax	wax
hutchinson	hutchinson
overturned	nhằm
tango	tango
lara	lara
strokes	strokes
mont	mont
pigeon	dua
pigeon	pigeon
pigeon	patagioenas
lyons	lyons
stairs	dục
madhya	madhya
grip	grip
grip	grep
grip	giựt
skater	skater
clone	clone
ravens	quạ
ravens	ravens
takeover	takeover
retrieve	retrieve
traction	traction
humboldt	humboldt
pulp	pulp
plata	plata
picnic	picnic
decks	boong
czechoslovak	czechoslovak
worms	giun
worms	worms
boone	boone
lam	lam
lam	lâm
lagoon	đầm
lagoon	lagoon
soo	tô
soo	soo
threatens	đe
buffy	buffy
presley	presley
timor	timor
mackay	mackay
tire	lốp
chestnut	chestnut
dem	dem
simone	simone
bernie	ticket
bernie	bernie
bags	túi
champagne	champagne
düsseldorf	düsseldorf
musicals	musicals
complexes	complexes
neighbourhoods	neighbourhoods
concurrent	concurrent
carrie	carrie
mughal	mughal
monmouth	monmouth
forested	forested
mccoy	mccoy
args	args
closes	đóng
burgess	burgess
tavern	tavern
wmf	wmf
petit	petit
reno	thừa
reno	reno
racehorse	racehorse
jong	jong
kitty	kitty
seahawks	seahawks
workplace	workplace
benz	benz
cha	cha
reissue	reissue
rebuild	tái
motorcycles	môtô
covenant	covenant
minus	trừ
weimar	weimar
hoover	hoover
dolphin	dolphin
ella	ella
glasses	kính
bowen	bowen
hindus	hindus
handicap	tật
ware	ware
jurassic	jurassic
amphibians	amphibians
implying	ro
siding	siding
trench	rãnh
spi	spi
sanchez	sanchez
wishing	ước
revue	revue
imam	imam
radioactive	radioactive
tipperary	tipperary
tonga	tonga
erotic	erotic
belmont	belmont
farrell	farrell
torch	torch
torch	đuốc
lois	lois
ramos	ramos
filters	lọc
damon	damon
rubin	rubin
katrina	katrina
ambient	ambient
dare	dám
insult	xúc
claudia	claudia
literal	literal
middleweight	middleweight
crushed	vỡ
crushed	rụi
brunei	brunei
dots	chấm
vegetable	rau
siberia	sibir
siberia	siberia
birch	birch
syndicate	syndicate
wwf	wwf
stall	stall
shifts	ca
theresa	theresa
biographer	biographer
gma	gma
benton	benton
nos	nos
commemorative	commemorative
gnu	gnu
lsu	lsu
gao	gao
gao	cao
lac	lac
watkins	watkins
passionate	hâm
waterfall	thác
genealogy	phả
genealogy	genealogy
discouraged	nản
discouraged	discouraged
centenary	centenary
empirical	empirical
charting	charting
snyder	snyder
fairfax	fairfax
rails	rails
westphalia	westphalia
exhaust	xả
twisted	oằn
twisted	xoắn
twisted	twisted
vitamin	vitamin
alvin	alvin
mecklenburg	mecklenburg
mecklenburg	ludwigslust
nippon	nippon
jealous	ghen
brutal	brutal
shaun	shaun
kung	kung
worm	giun
worm	worm
akin	akin
viruses	virus
viruses	virut
odi	odi
butcher	butcher
lim	lim
andersen	andersen
césar	césar
weasel	chồn
itn	itn
mock	mock
kara	kara
atlantis	atlantis
freak	freak
amtrak	amtrak
wien	wien
eliot	eliot
speculative	speculative
semitic	semitic
mla	mla
harmonica	harmonica
outlook	outlook
mast	buồm
dug	dug
heirs	heirs
mitch	mitch
uae	uae
abel	abel
abel	able
alexa	alexa
dar	dar
cromwell	cromwell
kathy	kathy
kensington	kensington
pomerania	pomerania
cfm	cfm
españa	españa
fancy	fancy
tor	tor
wikisource	wikisource
doris	doris
cocaine	cocaine
cocaine	buôn
cocaine	cocain
bauer	bauer
erich	erick
erich	erich
mainz	mainz
dwellings	dwellings
ramp	dốc
socialists	socialists
semester	ky
che	che
rollback	rollback
samsung	samsung
albuquerque	albuquerque
freelance	freelance
stretching	duỗi
topology	topology
neurons	neurons
woodlands	woodlands
standalone	standalone
cobb	cobb
halo	quầng
halo	halo
grange	grange
mendoza	mendoza
lip	môi
lip	lip
raphael	raphael
raphael	pantheon
lyrical	lyrical
colchester	colchester
gallagher	gallagher
amos	amos
pitchfork	pitchfork
scarborough	scarborough
quasi	quasi
northamptonshire	northamptonshire
aggression	aggression
dressing	dressing
lea	lea
juliet	juliet
principally	principally
schleswig	schleswig
fresno	fresno
suzanne	suzanne
uncovered	uncovered
polling	polling
abd	abd
sunlight	nắng
tyrone	tyrone
syed	syed
accession	accession
tutor	latin
darlington	darlington
tar	ín
tar	tar
complain	than
singaporean	singapore
ing	ing
sar	sar
sedan	sedan
antique	antique
morales	morales
choi	choi
furious	furious
buccaneers	buccaneers
ghetto	ghetto
velvet	velvet
velvet	nhung
concacaf	concacaf
punt	punt
ljubljana	ljubljana
irwin	irwin
pad	pad
autobiographical	autobiographical
yukon	yukon
rockefeller	rockefeller
interception	interception
shining	shining
spokesperson	spokesperson
toilet	toilet
pol	pol
pol	pool
orchard	orchard
rutherford	rutherford
rfd	rfd
kramer	kramer
romney	romney
advocating	advocating
pueblo	pueblo
nuremberg	nürnberg
nuremberg	nuremberg
finch	finch
grammatical	grammatical
knots	hải
divinity	divinity
fixtures	fixtures
théâtre	théâtre
shy	shy
shy	ngại
buckinghamshire	buckinghamshire
sai	sài
sino	sino
spectral	spectral
desmond	desmond
odyssey	odyssey
hiring	tuyển
phosphate	phosphate
wesleyan	wesleyan
caledonia	caledonia
darts	dart
animalia	animalia
cancellation	hủy
knoxville	knoxville
peacock	peacock
michele	michele
shipbuilding	shipbuilding
