que	che
del	del
los	gli
con	con
las	le
una	una
categoría	categoria
para	per
como	come
fue	fu
más	più
score	score
también	anche
entre	tra
entre	fra
este	questo
pero	ma
años	anni
dos	dos
dos	due
son	sono
sobre	circa
año	anno
desde	da
esta	questa
enlaces	collegamenti
hasta	fino
externos	esterni
ciudad	città
ser	essere
parte	parte
durante	durante
sin	senza
donde	dove
san	san
era	era
nacional	nazionale
primera	primo
primera	prima
está	sta
team	team
cuando	quando
seed	seed
nombre	nome
estados	stati
utc	utc
siglo	secolo
después	dopo
españa	spagna
tiene	ha
otros	altri
gran	grande
unidos	uniti
puede	può
estado	stato
uno	uno
lugar	luogo
primer	primo
así	così
población	popolazione
muy	molto
mismo	stesso
nueva	nuova
fueron	furono
historia	storia
club	club
eran	erano
cual	quale
vez	volta
universidad	università
forma	forma
tres	tre
grupo	gruppo
general	generale
guerra	guerra
familia	famiglia
además	inoltre
todo	tutto
sur	sud
mayor	maggiore
tiempo	tempo
provincia	provincia
partido	partito
contra	contro
encuentra	trova
otras	altre
todos	tutti
juan	giovanni
josé	giuseppe
bajo	basso
serie	serie
serie	seriale
cada	ogni
fútbol	calcio
equipo	attrezzatura
equipo	squadra
norte	nord
río	fiume
méxico	messico
han	han
argentina	argentina
inglés	inglese
nuevo	nuovo
véase	vedere
véase	vedi
septiembre	settembre
octubre	ottobre
segunda	seconda
ese	ese
ese	quello
discusión	discussione
gobierno	governo
condado	contea
final	finale
vida	vita
personas	persone
español	spagnolo
centro	centro
julio	luglio
lincoln	lincoln
país	paese
web	web
internacional	internazionale
santa	santa
antes	prima
oficial	ufficiale
mundo	mondo
embargo	pignoramento
tanto	sia
tanto	tanto
mayo	maggio
algunos	alcuni
temporada	stagione
hacia	verso
mejor	migliore
luego	poi
marzo	marzo
día	giorno
siendo	essendo
madrid	madrid
enero	gennaio
número	numero
agosto	agosto
diciembre	dicembre
artículo	articolo
noviembre	novembre
otro	altro
estaba	era
estaba	stavo
estos	questi
abril	aprile
total	totale
región	regione
sistema	sistema
habitantes	abitanti
maría	maria
real	real
real	reale
página	pagina
esto	questo
mundial	mondiale
mundial	mondiali
música	musica
presidente	presidenti
presidente	presidente
casa	casa
sólo	solo
álbum	album
debido	dovuto
cuenta	conto
junio	giugno
febrero	febbraio
ella	lei
ella	ella
pueden	potete
pueden	possono
varios	varie
varios	vari
varios	diversi
francia	francia
solo	solo
chile	cile
tipo	tipo
iglesia	chiesa
película	pellicola
película	film
entonces	allora
banda	banda
cuatro	quattro
zona	zona
televisión	televisione
principal	principale
tuvo	ebbe
carlos	carlo
otra	altra
rey	re
premio	premio
hace	fa
km²	km²
edición	edizione
tenía	avevo
tenía	aveva
premios	premi
futbolistas	calciatori
bien	bene
segundo	secondo
mar	mare
poco	poco
orden	ordine
estadounidense	americano
agua	acqua
tierra	terra
título	titolo
ellos	loro
earth	earth
están	stanno
división	divisione
canción	canzone
fecha	data
república	repubblica
trabajo	lavoro
especie	specie
luis	luigi
caso	caso
dentro	dentro
obras	opere
color	colore
distrito	distretto
superficie	superficie
copa	coppa
muchos	molti
near	near
línea	linea
francisco	francesco
les	les
siguiente	prossimo
siguiente	successivo
área	area
grandes	grandi
censo	censimento
liga	lega
estas	queste
align	align
muerte	morte
medio	mezzo
medio	medio
política	politica
menos	meno
largo	lungo
buenos	buoni
buenos	bravi
hijo	figlio
hecho	fatto
algunas	alcune
carrera	carriera
carrera	corsa
poder	potere
pueblo	villaggio
pueblo	popolo
departamento	dipartimento
veces	volte
reino	regno
central	centrale
todas	tutte
york	york
ejemplo	esempio
género	genere
padre	padre
isbn	isbn
campo	campo
isla	isola
hacer	fare
misma	stessa
ante	ante
conocido	conosciuto
http	http
países	paesi
frente	fronte
antonio	antonio
época	epoca
director	direttore
días	giorni
española	spagnola
partir	partire
versión	versione
varias	varie
actual	attuale
momento	momento
lista	elenco
jpg	jpg
densidad	densità
campeonato	campionato
tarde	pomeriggio
tienen	hanno
ejército	esercito
porque	perché
estación	stazione
observatorio	osservatorio
aires	aires
actualmente	attualmente
desarrollo	sviluppo
escuela	scuola
programa	programma
información	informazioni
importante	importante
último	ultimo
canciones	canzoni
uso	uso
juegos	giochi
localidad	località
base	base
punto	punto
posición	posizione
esa	quella
alemania	germania
ubicación	posizione
partidos	partiti
grupos	gruppi
john	john
miembros	membri
pedro	pietro
capital	capitale
primeros	primi
teatro	teatro
cualquier	qualsiasi
datos	dati
manera	modo
laboratorio	laboratorio
libro	libro
estudios	studi
diferentes	diversi
barcelona	barcellona
nivel	livello
llamado	chiamato
llamado	chiamata
mayoría	maggioranza
unión	unione
edad	età
toda	tutta
artículos	articoli
juego	gioco
arte	arte
especies	specie
europa	europa
estilo	stile
cine	cinema
proyecto	progetto
center	center
sea	sia
selección	selezione
costa	costa
equipos	squadre
origen	origine
código	codice
museo	museo
puntos	punti
perú	perù
militar	militare
américa	america
producción	produzione
italia	italia
manuel	emanuele
tener	avere
wikipedia	wikipedia
plantas	piante
comenzó	cominciò
debe	deve
siempre	sempre
metros	metri
oro	oro
posteriormente	successivamente
casi	quasi
construcción	costruzione
local	locale
francés	francese
cultura	cultura
santiago	santiago
cerca	vicino
estudio	monolocale
principales	principali
usuario	utente
com	com
finalmente	infine
finalmente	finalmente
cinco	cinco
cinco	cinque
anterior	precedente
cargo	addebito
batalla	battaglia
derecho	diritto
peak	peak
imagen	immagine
gracias	grazie
cuales	quali
kitt	kitt
puerto	porto
torneo	torneo
mucho	molto
social	sociale
social	social
millones	milioni
comunidad	comunità
fin	fine
acuerdo	accordo
lado	lato
colombia	colombia
servicio	servizio
rock	rock
político	politico
películas	film
ver	vedere
ver	visualizza
fuera	fuori
pesar	pesare
popular	popolare
muchas	molte
hoy	oggi
tal	tale
alto	alto
cuerpo	corpo
siguientes	seguenti
disco	disco
finales	finali
sociedad	società
tema	tema
dirección	indirizzo
hombres	uomini
última	ultima
última	ultimo
original	originale
estadio	stadio
ambos	entrambi
miguel	miguel
ley	legge
oeste	ovest
mujeres	donne
obs	obs
incluso	persino
incluso	anche
cambio	cambiamento
style	style
jugador	giocatore
instituto	istituto
público	pubblico
miembro	membro
superior	superiore
media	media
california	california
parque	parco
llegó	arrivò
archivo	archivio
radio	radio
ahora	adesso
ahora	ora
parís	parigi
sería	sarebbe
world	world
cruz	croce
cest	cest
brasil	brasile
unido	unito
red	rete
aquí	qui
canal	canale
movimiento	movimento
revista	rivista
éxito	successo
relación	relazione
elecciones	elezioni
plaza	piazza
grande	grande
distribución	distribuzione
compañía	compagnia
islas	isole
proceso	processo
alrededor	intorno
musical	musicale
musical	musical
primero	primo
primero	prima
territorio	territorio
encuentran	trovano
dice	dice
hombre	uomo
león	leone
algo	qualcosa
voz	voce
década	decennio
madre	madre
iii	iii
organización	organizzazione
monte	monte
aún	ancora
decir	dire
goles	gol
victoria	vittoria
sede	sede
importantes	importanti
resultado	risultato
china	cina
xix	xix
calle	strada
papel	carta
van	van
medios	mezzi
dio	diede
aparece	compare
aparece	appare
empresa	azienda
fernando	ferdinando
don	don
propio	proprio
mapa	mappa
civil	civile
venezuela	venezuela
educación	istruzione
término	termine
llamada	chiamata
ciudades	città
alta	alta
igual	uguale
usa	usa
allí	lì
allí	là
londres	londra
tercera	terza
fallecimiento	decesso
fuerzas	forze
posible	possibile
antiguo	antico
natural	naturale
álbumes	album
paso	passo
mujer	donna
fuerza	forza
altura	altezza
hijos	figli
etc	etc
etc	ecc
garcía	garcia
for	for
servicios	servizi
villa	villa
conocida	conosciuta
campeón	campione
autor	autore
modo	modalità
modo	modo
personajes	personaggi
conjunto	insieme
eso	quello
alemán	tedesco
meses	mesi
único	singolo
único	unico
actor	attore
parece	sembra
antigua	antica
especial	speciale
interior	interno
plata	argento
lemmon	lemmon
japón	giappone
control	controllo
consejo	consiglio
menor	minore
seis	sei
libre	libero
llegar	arrivare
valle	valle
festival	festival
personaje	personaggio
trata	tratta
principalmente	principalmente
david	davide
castillo	castello
publicado	pubblicato
cantante	cantante
referencia	riferimento
inglaterra	inghilterra
resto	resto
común	comune
editorial	editoriale
deporte	sport
saint	saint
espacio	spazio
asociación	associazione
hija	figlia
acción	azione
actores	attori
hermano	fratello
fundación	fondazione
blanco	bianco
profesional	professionista
profesional	professionale
episodio	episodio
cultural	culturale
principios	principi
imperio	impero
dicho	detto
nunca	mai
investigación	ricerca
prefijo	prefisso
from	from
problemas	problemi
modelo	modello
svg	svg
favor	favore
actividad	attività
joven	giovane
formación	formazione
lugares	luoghi
incluyendo	compreso
planta	pianta
período	periodo
montañas	montagna
ronda	ronda
clase	classe
especialmente	specialmente
oficina	ufficio
alcalde	sindaco
pasó	passò
estaban	stavano
estaban	erano
longitud	lunghezza
temas	temi
políticos	politici
deportivo	sportivo
arquitectura	architettura
creación	creazione
barrio	quartiere
argentino	argentino
libros	libri
novela	romanzo
jorge	giorgio
razas	razze
academia	accademia
jefe	capo
defensa	difesa
características	caratteristiche
honor	onore
incluye	comprende
incluye	include
existen	esistono
amor	amore
fuente	fonte
obtuvo	ottenne
nuevos	nuovi
martín	martín
situación	situazione
nombrado	nominato
existe	esiste
derechos	diritti
ministro	ministro
interés	interesse
series	serie
texto	testo
escritores	scrittori
actriz	attrice
persona	persona
capacidad	capacità
artes	attrezzi
cantidad	quantità
situada	situata
fuentes	fonti
vista	vista
luz	luce
baja	bassa
border	border
paz	pace
tercer	terzo
vuelta	ritorno
noche	notte
muestra	campione
rusia	russia
personal	personale
robert	robert
aeropuerto	aeroporto
apoyo	supporto
apoyo	sostegno
semana	settimana
palacio	palazzo
propia	propria
pacífico	pacifico
escritor	scrittore
castilla	castiglia
profesor	insegnante
profesor	professore
roma	roma
diseño	progettazione
diseño	disegno
casos	casi
negro	nero
camino	cammino
ayuda	aiuto
nombres	nomi
podría	potrebbe
podría	potrei
causa	causa
horario	orario
ciencias	scienze
últimos	ultimi
tamaño	dimensione
principio	principio
periodo	periodo
nacimiento	nascita
nada	niente
etapa	tappa
actualidad	attualità
pequeño	piccolo
santo	santo
zonas	aree
zonas	zone
lópez	lopez
referencias	referenze
referencias	riferimenti
única	unica
ediciones	edizioni
dios	dio
debut	debutto
presente	presente
congreso	congresso
guitarra	chitarra
australia	australia
qué	cosa
pablo	paolo
elementos	elementi
relaciones	relazioni
compuesto	composto
horas	ore
partes	parti
text	text
lengua	lingua
militares	militari
torre	torre
dado	dado
dado	dato
actividades	attività
nacionales	nazionali
cantón	cantone
nuevas	nuove
sencillo	semplice
federal	federale
participación	partecipazione
fuerte	forte
italiano	italiano
primeras	prime
posee	possiede
jugadores	giocatori
seguridad	sicurezza
administración	amministrazione
empresas	aziende
empresas	imprese
mercado	mercato
gonzález	gonzález
lucha	lotta
estructura	struttura
jesús	gesù
ocupación	occupazione
cet	cet
nacido	nato
enrique	enrico
literatura	letteratura
católica	cattolica
armas	armi
energía	energia
idioma	lingua
valencia	valencia
cabeza	testa
gobernador	governatore
geográfica	geografica
córdoba	córdoba
mes	mese
situado	situato
diferencia	differenza
objetivo	obiettivo
ruta	percorso
perteneciente	appartenente
economía	economia
histórico	storico
india	india
flores	fiori
visita	visita
conde	conte
fase	fase
william	william
resultados	risultati
nos	ci
niños	bambini
tales	tali
https	https
pequeña	piccola
presenta	presenta
campaña	campagna
dar	dare
pública	pubblica
fernández	fernández
occidental	occidentale
aproximadamente	circa
aproximadamente	approssimativamente
ocasiones	occasioni
tropas	truppe
sección	sezione
presencia	presenza
permite	permette
sentido	senso
uruguay	uruguay
ficha	scheda
tenían	avevano
top	top
siete	sette
ets	ets
animales	animali
esposa	moglie
ríos	fiumi
catalina	caterina
you	you
may	may
murió	morì
bar	bar
medalla	medaglia
función	funzione
usuarios	utenti
programas	programmi
des	des
calidad	qualità
artistas	artisti
similar	simile
nuestra	nostra
independencia	indipendenza
buena	buona
sistemas	sistemi
significa	significa
virgen	vergine
transporte	trasporti
pueblos	popoli
rodríguez	rodriguez
coordenadas	coordinate
vol	vol
valor	valore
internacionales	internazionali
unidad	unità
crear	creare
creo	credo
creo	penso
imágenes	immagini
inicio	inizio
salud	salute
contiene	contiene
será	sarà
idea	idea
minutos	minuti
diego	diego
verano	estate
sol	sole
teoría	teoria
revolución	rivoluzione
entrada	entrata
mejores	migliori
mando	comando
decidió	decise
james	james
ciencia	scienza
records	records
aire	aria
sector	settore
importancia	importanza
ataque	attacco
flora	flora
comunicación	comunicazione
jean	jean
puente	ponte
width	width
matrimonio	matrimonio
material	materiale
volvió	tornò
humanos	umani
mitad	metà
realidad	realtà
gente	persone
cámara	fotocamera
escudo	scudo
pérez	perez
aguas	acque
acceso	accesso
clasificación	classificazione
mano	mano
sociales	social
problema	problema
trabajos	lavori
elegido	prescelto
elegido	eletto
independiente	indipendente
ningún	nessun
futbolista	calciatore
comercial	commerciale
metal	metallo
diario	quotidiano
diario	diario
palabra	parola
carácter	carattere
falta	manca
falta	mancanza
reina	regina
corte	taglio
domingo	domenica
libertad	libertà
vía	via
xviii	xviii
unidades	unità
capitán	capitano
bgcolor	bgcolor
políticas	politiche
sevilla	siviglia
video	video
considerado	considerato
comisión	commissione
lima	lima
alberto	alberto
comienza	inizia
velocidad	velocità
felipe	filippo
objetos	oggetti
ministerio	ministero
creado	creato
xvi	xvi
oriental	orientale
hermanos	fratelli
edificios	edifici
tierras	terre
cosas	cose
michael	michael
británico	britannico
áfrica	africa
izquierda	sinistra
cambios	cambiamenti
martínez	martínez
quedó	rimase
canadá	canada
alfonso	alfonso
lanzado	lanciato
lanzado	liberato
bandera	bandiera
videojuegos	videogiochi
rica	ricca
verde	verde
templo	tempio
raza	razza
avenida	viale
regional	regionale
posterior	posteriore
biblioteca	biblioteca
rojo	rosso
títulos	titoli
reporte	segnalazione
blancos	bianchi
diez	dieci
ángel	angelo
ecuador	ecuador
señor	signore
productos	prodotti
portugal	portogallo
salvador	salvatore
manos	mani
carretera	strada
escrito	scritto
industria	industria
entrenador	allenatore
palabras	parole
padres	genitori
sánchez	sánchez
sánchez	sanchez
policía	polizia
líder	leader
fondo	sfondo
pudo	poté
productor	produttore
técnica	tecnica
ninguna	nessuna
príncipe	principe
áreas	aree
press	press
encontrar	trovare
plan	piano
artista	artista
formas	forme
von	von
rafael	raffaele
atlético	atletico
jun	jun
catedral	cattedrale
generalmente	generalmente
ayuntamiento	municipio
cuarto	quarto
saludos	saluti
temporadas	stagioni
ambas	entrambe
colección	collezione
cadena	stringa
music	music
combate	combattimento
azul	blu
azul	azzurro
motivo	movente
líneas	linee
cuanto	quanto
pasado	passato
páginas	pagine
george	george
españoles	spagnoli
medida	misura
influencia	influenza
lago	lago
conoce	incontra
condiciones	condizioni
oficiales	ufficiali
left	left
hospital	ospedale
ocho	ocho
ocho	otto
fuego	fuoco
piedra	pietra
sub	sub
federación	federazione
black	black
constitución	costituzione
tratado	trattato
razón	ragione
mil	mille
comercio	commercio
pop	pop
distancia	distanza
estudiantes	studenti
jul	lug
internet	internet
episodios	episodi
propiedad	proprietà
marca	marca
tipos	tipi
baloncesto	pallacanestro
contenido	contenuto
todavía	ancora
anteriores	precedenti
haciendo	facendo
map	map
estrella	stella
viaje	viaggio
rosa	rosa
dejó	lasciò
jóvenes	giovani
realizado	realizzato
formato	formato
tour	tour
prueba	prova
feb	feb
peso	peso
cómo	come
washington	washington
mal	male
mal	sbagliato
jersey	jersey
abr	apr
locales	locali
der	der
marco	marco
sep	sep
llega	arriva
daniel	daniele
musicales	musical
eduardo	edoardo
oct	ott
duque	duca
amigo	amico
evitar	evitare
emperador	imperatore
restos	resti
ingresos	entrate
santos	santi
obispo	vescovo
pocos	pochi
toma	tieni
toma	prendi
campos	campi
nov	nov
mexicano	messicano
formar	formare
kilómetros	chilometri
justicia	giustizia
ago	ago
bastante	abbastanza
love	love
señora	signora
deben	devono
realiza	realizza
dic	dic
ana	anna
naturales	naturali
alejandro	alessandro
publicación	pubblicazione
figura	figura
soldados	soldati
blanca	bianca
aves	uccelli
peter	peter
pie	piede
amigos	amici
particular	particolare
numerosos	numerosi
crítica	critica
maestro	maestro
cuba	cuba
asia	asia
motor	motore
efecto	effetto
completo	completo
sencillos	semplici
trabajó	lavorò
crecimiento	crescita
doctor	dottore
pequeños	piccoli
autores	autori
junta	giunta
europeo	europeo
grado	grado
buen	buon
facultad	facoltà
cataluña	catalogna
extremo	estremo
tradicional	tradizionale
derecha	destra
niño	bambino
plantilla	modello
votos	voti
banco	panchina
consiguió	ottenne
contrato	contratto
pintura	pittura
ruso	russo
cuenca	bacino
batería	batteria
diputados	deputati
pasa	passa
andrés	andrea
máximo	massimo
deportes	sport
representa	rappresenta
recursos	risorse
misión	missione
compositor	compositore
corresponden	corrispondono
futuro	futuro
ángeles	angeli
utilizado	usato
vicente	vincenzo
hacen	fanno
tecnología	tecnologia
trabajar	lavorare
considera	considera
tiempos	tempi
ramón	ramon
fiesta	festa
smith	smith
jardín	giardino
madera	legno
inferior	inferiore
mexicana	messicano
solid	solid
incluyen	includono
alcanzar	raggiungere
frontera	confine
atención	attenzione
digital	digitale
torres	torri
doble	doppia
referirse	riferirsi
comandante	comandante
corazón	cuore
secretario	segretario
charles	charles
letras	lettere
lenguas	lingue
vivo	vivo
xvii	xvii
encuentro	incontro
obtener	ottenere
originalmente	originariamente
naturaleza	natura
claro	chiaro
existencia	esistenza
man	man
guatemala	guatemala
bajos	bassi
aragón	aragona
juega	gioca
rico	ricco
sonido	suono
usar	usare
mensajes	messaggi
firme	firmi
mesa	tavolo
granada	granada
antiguos	antichi
pasar	passare
objeto	oggetto
generales	generali
apertura	apertura
geografía	geografia
análisis	analisi
protección	protezione
géneros	generi
naciones	nazioni
familias	famiglie
ferrocarril	ferrovia
notas	note
american	american
proyectos	progetti
white	white
funciones	funzioni
corona	corona
apareció	apparve
apareció	apparso
clima	clima
guillermo	guglielmo
prensa	stampa
haya	faggio
escena	scena
provincial	provinciale
versiones	versioni
www	www
isabel	elisabetta
gómez	gómez
numerosas	numerose
puerta	porta
mario	mario
romano	romano
griego	greco
all	all
tuvieron	ebbero
habla	parla
cierto	vero
crisis	crisi
efectos	effetti
memoria	memoria
orquesta	orchestra
creó	creò
siglos	secoli
montaña	montagna
mantener	mantenere
mantener	mantieni
#aaa	#aaa
austria	austria
llegada	arrivo
construido	costruito
martin	martin
berlín	berlino
llama	chiama
directamente	direttamente
lanzamiento	lancio
comité	comitato
javier	javier
capilla	cappella
probablemente	probabilmente
larga	lunga
colspan	colspan
bolivia	bolivia
poeta	poeta
tradición	tradizione
podía	poteva
podía	potevo
provincias	province
produce	produce
autónoma	autonoma
hojas	foglie
ricardo	riccardo
soviética	sovietica
tomar	prendere
necesario	necessario
filosofía	filosofia
periodista	giornalista
texas	texas
jugar	giocare
operación	operazione
papa	papa
latinos	latini
firma	firma
nacionalidad	nazionalità
patrimonio	patrimonio
regiones	regioni
poesía	poesia
hermana	sorella
decide	decide
alianza	alleanza
respuesta	risposta
google	google
pruebas	prove
richard	richard
richard	riccardo
médico	medico
metro	metropolitana
marina	marina
eventos	eventi
exterior	esterno
músicos	musicisti
visto	visto
aquellos	quelli
suiza	svizzera
coronel	colonnello
parroquia	parrocchia
física	fisica
dan	dan
anteriormente	precedentemente
práctica	pratica
grecia	grecia
zaragoza	saragozza
exposición	esposizione
industrial	industriale
asiáticos	asiatici
cuadro	tabella
fundada	fondata
enfermedad	malattia
nba	nba
colonia	colonia
díaz	diaz
pequeñas	piccole
nación	nazione
show	spettacolo
national	national
anunció	annunciato
extensión	estensione
régimen	regime
dinero	soldi
suelo	pavimento
suelo	suolo
aparición	comparsa
aparición	apparizione
operaciones	operazioni
concepto	concetto
calles	strade
encontraba	trovavo
encontraba	trovava
hechos	fatti
pronto	presto
gestión	gestione
hall	hall
recibe	ricevi
salida	partenza
capítulo	capitolo
italiana	italiana
acciones	azioni
pertenece	appartiene
cristo	cristo
medicina	medicina
evolución	evoluzione
alcanzó	raggiunse
modelos	modelli
venta	vendita
fundador	fondatore
piano	pianoforte
procedencia	provenienza
roberto	roberto
mismos	stessi
ganar	vincere
pintor	pittore
evento	evento
campeonatos	campionati
alemana	tedesca
rosario	rosario
menores	minori
solamente	soltanto
pertenecían	appartenevano
hispanos	ispanici
conocimiento	conoscenza
conocer	conoscere
términos	termini
debajo	sotto
generación	generazione
bronce	bronzo
tabla	tabella
vio	vide
armada	armata
pareja	coppia
producto	prodotto
territorios	territori
gol	gol
institución	istituzione
ingeniero	ingegnere
luna	luna
reconocimiento	riconoscimento
península	penisola
escrita	scritta
organizaciones	organizzazioni
llevar	portare
bahía	baia
adelante	avanti
asamblea	assemblea
cerro	collina
enlace	link
till	till
traducción	traduzione
hicieron	fecero
tracking	tracking
fundado	fondato
paraguay	paraguay
alguien	qualcuno
ganador	vincitore
estrellas	stelle
sangre	sangue
resistencia	resistenza
continuación	proseguimento
continuación	continuazione
neat	neat
conflicto	conflitto
software	software
afroamericanos	afroamericani
volumen	volume
vuelve	ritorna
xxi	xxi
técnico	tecnico
humano	umano
consecuencia	conseguenza
colaboración	collaborazione
aparecen	compaiono
aparecen	appaiono
colores	colori
materiales	materiali
carta	lettera
categorías	categorie
curso	corso
tenido	avuto
fiestas	feste
simplemente	semplicemente
japonés	giapponese
opinión	opinione
franco	franco
temperatura	temperatura
propuesta	proposta
eds	eds
decreto	decreto
decisión	decisione
concepción	concezione
cara	faccia
carolina	carolina
lee	leggi
botánica	botanica
editor	editore
polonia	polonia
experiencia	esperienza
abierto	aperto
participantes	partecipanti
instituciones	istituzioni
monasterio	monastero
castro	castro
sean	sean
amerindios	amerindi
suecia	svezia
inicialmente	inizialmente
nota	nota
concurso	concorso
seguir	seguire
marqués	marchese
altitud	altitudine
dólares	dollari
peces	pesci
planeta	pianeta
israel	israele
marcha	marcia
representación	rappresentanza
turismo	turismo
publicaciones	pubblicazioni
ingeniería	ingegneria
frecuencia	frequenza
semanas	settimane
basado	basato
saber	sapere
olímpico	olimpico
utilizar	usare
utilizar	utilizzare
piezas	pezzi
participar	partecipare
poner	mettere
corea	corea
borrado	cancellazione
borrado	cancellato
carmen	carmen
creada	creata
religión	religione
técnicas	tecniche
estaciones	stazioni
escuelas	scuole
elección	scelta
clases	classi
completamente	completamente
relacionados	correlati
vuelo	volo
xiii	xiii
parlamento	parlamento
titular	titolare
deja	lascia
florida	florida
económico	economico
descrito	descritto
rápidamente	velocemente
sabe	sa
nave	nave
posibilidad	possibilità
destaca	evidenzia
html	html
anderson	anderson
directo	diretto
usado	usato
sucesor	successore
presidencia	presidenza
totalmente	completamente
oficialmente	ufficialmente
volver	ritorna
volver	ritornare
botánico	botanico
iglesias	chiese
composición	composizione
método	metodo
concierto	concerto
cuarta	quarta
agricultura	agricoltura
par	coppia
capaz	capace
viejo	vecchio
tratamiento	trattamento
palomar	palomar
especiales	speciali
nueve	nove
bosque	foresta
ganado	bestiame
carga	carico
carga	carica
quiere	vuole
letra	lettera
debutó	debuttato
necesidad	bisogno
necesidad	necessità
diócesis	diocesi
dejar	lasciare
consiste	consiste
registro	registrazione
regreso	ritorno
duración	durata
acto	atto
life	life
indica	indica
bandas	bande
voto	voto
nicolás	nicola
arquitecto	architetto
solar	solare
perdió	perse
playa	spiaggia
rango	intervallo
cantantes	cantanti
latina	latina
conseguir	ottenere
femenino	femminile
regresó	tornò
instalaciones	impianti
vive	vivi
louis	louis
derrota	sconfitta
vii	vii
king	king
sola	sola
basada	basata
césar	cesare
castellano	castellano
urbano	urbano
international	international
forman	formano
oriente	oriente
campeones	campioni
leyes	leggi
estructuras	strutture
entrevista	intervista
niveles	livelli
arco	arco
justo	giusto
right	right
socialista	socialista
art	art
administrativa	amministrativa
difícil	difficile
one	one
novelas	romanzi
conocidos	conoscenti
super	super
discos	dischi
simple	semplice
listas	elenchi
sebastián	sebastiano
histórica	storica
diputado	deputato
ideas	idee
ojos	occhi
continuó	continuò
músico	musicista
busca	cerca
números	numeri
destino	destinazione
vasco	basco
contacto	contatto
reforma	riforma
teniendo	avendo
carreras	carriere
expedición	spedizione
invierno	inverno
nadie	nessuno
diferente	diverso
park	park
romana	romana
barrios	quartieri
ofrece	offre
navarra	navarra
relevancia	pertinenza
ancho	larghezza
grabación	registrazione
esas	quelle
boca	bocca
panamá	panama
universal	universale
completa	completa
negra	nera
dando	dando
variedad	varietà
dominio	dominio
trabajadores	lavoratori
star	star
valores	valori
movimientos	movimenti
movimientos	mosse
océano	oceano
promedio	media
árabe	arabo
aplicación	applicazione
famoso	famoso
interpretación	interpretazione
competición	competizione
compuesta	composta
terreno	terreno
respectivamente	rispettivamente
entró	entrò
similares	simili
construir	costruire
toledo	toledo
periódico	giornale
noticias	notizie
miss	miss
normalmente	normalmente
piloto	pilota
abogado	avvocato
chicago	chicago
clásico	classico
ópera	opera
candidato	candidato
debería	dovrebbe
desarrollado	sviluppato
designado	designato
activo	attivo
irlanda	irlanda
detrás	dietro
detrás	indietro
llegando	arrivando
xii	xii
descripción	descrizione
aspecto	aspetto
realizada	realizzata
vídeo	video
presión	pressione
henry	henry
conciertos	concerti
vecinos	vicini
lorenzo	lorenzo
federico	federico
competencia	concorrenza
sky	sky
punta	punta
fórmula	formula
núcleo	nucleo
illinois	illinois
galería	galleria
puso	mise
humana	umana
iba	andavo
cambiar	cambiare
cambiar	cambia
nelson	nelson
asturias	asturie
verdad	vero
une	unisce
joaquín	joaquin
juventud	gioventù
golpe	colpo
avión	aereo
estadounidenses	americani
masa	massa
joseph	joseph
bienes	beni
egipto	egitto
moderna	moderna
intento	tentativo
textos	testi
presentación	presentazione
muerto	morto
escribir	scrivere
históricos	storici
reserva	prenotazione
live	live
árboles	alberi
comienzo	inizio
denominación	denominazione
hábitat	habitat
lenguaje	linguaggio
unidas	unite
asistencia	assistenza
judíos	ebrei
expresión	espressione
inicial	iniziale
ejecutivo	esecutivo
portugués	portoghese
bélgica	belgio
órdenes	ordini
ignacio	ignazio
torneos	tornei
corto	corti
corto	corto
corto	breve
chileno	cileno
populares	popolari
usando	utilizzando
usando	usando
science	science
clara	chiara
normal	normale
búsqueda	ricerca
sello	sigillo
revistas	riviste
teniente	tenente
álvarez	álvarez
mark	mark
mendoza	mendoza
comerciales	commerciali
titulado	intitolato
residencia	residenza
jazz	jazz
indígenas	indigeni
massachusetts	massachusetts
jack	jack
café	caffè
podemos	possiamo
hierro	ferro
nuestro	nostro
latín	latino
oposición	opposizione
árbol	albero
global	global
escala	scala
salió	uscì
bueno	buono
muertos	morti
valladolid	valladolid
bogotá	bogotá
reales	veri
reales	reali
comunidades	comunità
pierre	pierre
marcos	marco
vivir	vivere
die	die
fama	fama
united	united
gabriel	gabriele
debía	doveva
votación	votazione
apenas	appena
biografía	biografia
vino	vino
alonso	alonso
caída	caduta
sonora	sonora
visión	visione
hacía	faceva
hacía	facevo
arena	sabbia
límite	limite
entrar	entrare
noruega	norvegia
canales	canali
materia	materia
roja	rosso
data	data
regular	regolare
promoción	promozione
salir	uscire
autoridad	autorità
bellas	belle
caracas	caracas
comenzaron	cominciarono
pasando	succedendo
pasando	passando
demasiado	troppo
accidente	incidente
image	image
medidas	misure
siguió	continuò
dejando	lasciando
críticas	critiche
aviones	aerei
conquista	conquista
estoy	sto
cuartos	stanze
células	cellule
alemanes	tedeschi
laguna	laguna
montevideo	montevideo
protagonista	protagonista
pérdida	perdita
corresponde	corrisponde
alma	anima
caballero	cavaliere
retiro	ritiro
enciclopedia	enciclopedia
jaime	giacomo
dinastía	dinastia
aspectos	aspetti
procesos	processi
salón	salone
ataques	attacchi
tony	tony
breve	breve
zip	zip
universo	universo
imperial	imperiale
sitios	siti
bot	bot
emisión	emissione
abajo	giù
múltiples	multipli
múltiples	multiple
homenaje	omaggio
guardia	guardia
miles	migliaia
rural	rurale
pantalla	schermo
convento	convento
clásica	classica
grabado	registrato
grabado	incisione
considerada	considerata
corriente	corrente
quinto	quinto
legislatura	legislatura
puertas	porte
ruiz	ruiz
disponible	disponibile
ocasión	occasione
mantiene	mantiene
dulce	dolce
óscar	oscar
tribunal	corte
tribunal	tribunale
profesores	insegnanti
posiciones	posizioni
últimas	ultime
honduras	honduras
conferencia	conferenza
tom	tom
dvd	dvd
comentarios	commenti
royal	royal
naval	navale
científico	scientifico
científico	scienziato
oportunidad	opportunità
documentos	documenti
viene	viene
anual	annuale
elemento	elemento
time	time
actos	atti
west	west
agustín	agostino
vega	vega
infantil	infantile
escenario	palcoscenico
brown	brown
flota	flotta
clave	chiave
css	css
atlántico	atlantico
alexander	alexander
condición	condizione
jones	jones
construida	costruita
moscú	mosca
hernández	hernandez
profesionales	professionisti
quién	chi
cuestión	questione
aumento	aumento
encontrado	trovato
mejorar	migliorare
comunes	comuni
víctor	vittorio
youtube	youtube
públicos	pubblico
rojas	rosse
caja	scatola
guerras	guerre
formada	formata
cabecera	intestazione
rowspan	rowspan
territorial	territoriale
declaró	dichiarò
var	var
responsable	responsabile
cortes	tagli
guadalajara	guadalajara
dedicado	dedicato
org	org
instrumentos	strumenti
ciclo	ciclo
incluido	incluso
señal	segnale
amplia	ampia
amplia	vasta
williams	williams
murcia	murcia
vehículos	veicoli
und	und
franceses	francesi
hungría	ungheria
civiles	civili
liberal	liberale
catalán	catalano
tropical	tropicale
ejemplos	esempi
secundaria	secondaria
masculino	maschile
altos	alti
xiv	xiv
realmente	veramente
realmente	davvero
doce	dodici
doce	doce
americano	americano
burgos	burgos
siguiendo	seguendo
recientemente	recentemente
instrumento	strumento
salamanca	salamanca
ayudar	aiutare
portada	copertina
identidad	identità
pasajeros	passeggeri
suficiente	abbastanza
suficiente	sufficiente
mezcla	miscela
buscar	ricerca
infantería	fanteria
culto	culto
historias	storie
duda	dubbio
big	big
actuales	attuali
pies	piedi
ida	ida
presentan	presentano
utilizan	usano
utilizan	utilizzano
url	url
recorrido	percorso
recorrido	corsa
comunista	comunista
leyenda	leggenda
comedia	commedia
mañana	domani
tomás	tommaso
fotografía	fotografia
romanos	romani
etiqueta	etichetta
ohio	ohio
cable	cavo
mensaje	messaggio
hugo	ugo
altas	alte
décadas	decenni
poderes	poteri
permanente	permanente
anime	anime
antiguas	antiche
antiguas	vecchie
química	chimica
plataforma	piattaforma
razones	motivi
razones	ragioni
poblaciones	popolazioni
potencia	potenza
espíritu	spirito
pro	pro
artístico	artistico
house	house
vivió	visse
rol	ruolo
tren	treno
misiones	missioni
princesa	principessa
college	college
audiencia	audizione
entrega	consegna
valign	valign
invasión	invasione
límites	limiti
enseñanza	insegnamento
asteroides	asteroidi
correspondiente	corrispondente
reconocido	riconosciuto
reunión	riunione
ocupa	occupa
estándar	standard
representantes	rappresentanti
frank	frank
programación	programmazione
entidad	entità
compañeros	compagni
animal	animale
recibido	ricevuto
grand	grand
escultura	scultura
saga	saga
destacar	evidenziare
motivos	motivi
espacios	spazi
introducción	introduzione
fuertes	forti
bases	basi
sureste	sudest
bretaña	bretagna
chino	cinese
viii	viii
récord	record
fauna	fauna
raíz	radice
profundidad	profondità
sirve	serve
japonesa	giapponese
crea	crea
científicos	scienziati
cabe	cabe
history	history
universidades	università
termina	finisce
termina	termina
ciudadanos	cittadini
símbolo	simbolo
copias	copie
virginia	virginia
descrita	descritta
primaria	elementare
primaria	primaria
distritos	distretti
rápido	veloce
list	list
moderno	moderno
eléctrica	elettrico
zelanda	zelanda
utilizando	usando
utilizando	utilizzando
pocas	poche
pobreza	povertà
fachada	facciata
error	errore
ministros	ministri
ventas	vendite
conservación	conservazione
scott	scott
contexto	contesto
propiedades	proprietà
historiador	storico
enfermedades	malattie
prácticamente	praticamente
cola	coda
exteriores	esterni
constante	costante
asesinato	omicidio
asesinato	assassinio
cádiz	cadice
natal	natal
celebra	festeggia
recibir	ricevere
juntos	insieme
individuales	singolo
fábrica	fabbrica
machos	maschi
title	title
paris	parigi
chan	chan
chilena	cilena
restauración	restauro
roca	pietra
cargos	accuse
prisión	prigione
prisión	carcere
sale	esce
dedicada	dedicata
mismas	stesse
religiosos	religiosi
pintores	pittori
filipinas	filippine
privada	privato
intervención	intervento
juicio	giudizio
escenas	scene
europeos	europei
permaneció	rimase
documental	documentario
expansión	espansione
convertido	convertito
entrenadores	allenatori
igualmente	altrettanto
tradicionales	tradizionali
pan	pane
quinta	quinta
trono	trono
noreste	nordest
inmediatamente	immediatamente
familiar	familiare
riesgo	rischio
desambiguación	disambigua
hablar	parlare
inicia	avvia
windows	windows
ermita	eremo
caza	caccia
reacción	reazione
llamados	chiamati
humanidad	umanità
guerrero	guerriero
seguido	seguito
tramo	tratto
uefa	uefa
representante	rappresentante
empieza	inizia
rugby	rugby
chris	chris
dakota	dakota
galicia	galizia
max	max
pensilvania	pennsylvania
caribe	caraibi
perfil	profilo
escocia	scozia
png	png
definición	definizione
simon	simon
establecer	imposta
establecer	impostare
amarillo	giallo
piel	pelle
sergio	sergio
primavera	primavera
mariano	mariano
gas	gas
solución	soluzione
diferencias	differenze
dominicana	dominicana
dimensiones	dimensioni
objetivos	obiettivi
fusión	fusione
atrás	indietro
coro	coro
eje	asse
hacerlo	farlo
pone	mette
mary	mary
regimiento	reggimento
formando	formando
nacidos	nati
php	php
canto	canto
licencia	licenza
idiomas	lingue
directa	diretta
directa	diretto
viena	vienna
bolívar	bolívar
posiblemente	possibilmente
continente	continente
cartas	lettere
corrientes	correnti
poemas	poesie
presentado	presentato
facebook	facebook
palma	palma
enemigo	nemico
cielo	paradiso
dinamarca	danimarca
excepto	eccetto
excepto	risparmi
excepto	tranne
excepto	salvo
minnesota	minnesota
producir	produrre
pico	picco
conserva	conserva
arma	arma
religiosa	religiosa
cementerio	cimitero
resolución	risoluzione
peña	peña
violencia	violenza
describe	descrivi
describe	descrive
terminología	terminologia
adaptación	adattamento
voces	voci
utilizada	utilizzata
bob	bob
individual	singola
soy	sono
once	undici
descubiertos	scoperti
esperanza	speranza
consumo	consumi
consumo	consumo
compañero	compagno
medieval	medievale
amplio	ampio
sudáfrica	sudafrica
teresa	teresa
agente	agente
alumnos	allievi
cuentos	racconti
impacto	impatto
alfredo	alfredo
trabajando	lavorando
emilio	emilio
kansas	kansas
blue	blue
secreto	segreto
propósito	scopo
colombiano	colombiano
inferiores	inferiori
north	north
peligro	pericolo
arroyo	ruscello
latino	latino
rama	ramo
argentinos	argentini
característica	caratteristica
raúl	raul
mantenimiento	manutenzione
morales	morales
dieron	diedero
estudiar	studiare
society	society
comentario	commento
ramírez	ramirez
circuito	circuito
sexual	sessuale
libres	liberi
llevado	sopportato
planes	piani
jackson	jackson
enemigos	nemici
fácil	facile
silva	silva
compositores	compositori
diámetro	diametro
éxitos	successi
artística	artistico
artística	artistica
victorias	vittorie
puestos	posti
podían	potevano
pieza	pezzo
científica	scientifica
guía	guida
podrían	potrebbero
arturo	arturo
superiores	superiori
frase	frase
cuerpos	corpi
renta	reddito
negocios	affari
ben	ben
excepción	eccezione
gustavo	gustavo
monumentos	monumenti
nace	nasce
funcionamiento	funzionamento
griega	greca
víctimas	vittime
conoció	conobbe
cita	citazione
terminar	terminare
guitarrista	chitarrista
turquía	turchia
triunfo	vittoria
llegado	arrivato
walter	walter
young	young
cristianos	cristiani
gutiérrez	gutiérrez
cantabria	cantabria
descubierto	scoperto
cáncer	cancro
métodos	metodi
delantero	anteriore
indiana	indiana
puebla	puebla
trabaja	lavora
min	min
caballeros	cavalieri
caballeros	signori
minas	miniere
comportamiento	comportamento
sucedió	accadde
originales	originali
nuclear	nucleare
billboard	billboard
escritos	scritti
santander	santander
viento	vento
americana	americana
normas	regole
normas	norme
sectores	settori
cónyuge	coniuge
espectadores	spettatori
rusa	russa
peruano	peruviano
liberación	liberazione
pez	pesce
quería	voleva
quería	volevo
atenas	atene
momentos	momenti
fifa	fifa
aplicaciones	applicazioni
limita	limita
air	air
georgia	georgia
hielo	ghiaccio
caballo	cavallo
steve	steve
significado	significato
cinturón	cintura
cordillera	cordigliera
crítico	critico
interpretado	interpretato
mis	miei
motores	motori
posibles	possibili
ganadores	vincitori
pilotos	piloti
mike	mike
foto	foto
wilson	wilson
británicos	britannici
joe	joe
sueño	sogno
guinea	guinea
informe	relazione
informe	rapporto
treinta	trenta
treinta	treinta
tráfico	traffico
órgano	organo
medallas	medaglie
archivos	schedario
fechas	date
south	south
dobles	doppia
directores	direttori
físico	fisico
democracia	democrazia
mediterráneo	mediterraneo
opción	opzione
perdido	perduto
perdido	perso
notable	notevole
tengo	ho
legal	legale
tercero	terzo
enorme	enorme
constitucional	costituzionale
plazo	termine
católicos	cattolici
escritura	scrittura
estadísticas	statistiche
documento	documento
críticos	critici
iowa	iowa
cristiana	cristiana
oscar	oscar
transmisión	trasmissione
carne	carne
poetas	poeti
ucrania	ucraina
desarrollar	sviluppare
ocurre	succede
ocurre	accade
enviado	inviato
muestran	mostrano
street	street
vehículo	veicolo
reparto	cast
círculo	cerchio
harry	harry
alimentos	alimenti
urbana	urbana
participa	partecipa
casado	sposato
semifinales	semifinali
abierta	aperta
habitual	abituale
agencia	agenzia
popularidad	popolarità
votar	votare
pinturas	dipinti
terminal	terminale
janeiro	janeiro
iniciativa	iniziativa
ffffff	ffffff
redes	reti
localización	localizzazione
fortaleza	fortezza
deriva	deriva
democrática	democratica
marido	marito
electrónica	elettronica
cristóbal	cristoforo
herrera	herrera
buques	navi
diccionario	dizionario
profesión	professione
consigue	ottiene
consulta	consultazione
historiadores	storici
mitología	mitologia
debate	dibattito
debate	discussione
perder	perdere
componentes	componenti
belleza	bellezza
descubre	scopri
jiménez	jiménez
personales	personali
ácido	acido
veo	vedo
infancia	infanzia
líderes	leader
espacial	spaziale
predecesor	predecessore
oscuro	buio
verdadero	vero
segundos	secondi
margen	margine
cañón	cannone
religioso	religioso
net	net
zamora	zamora
relativamente	relativamente
columna	colonna
danza	danza
veinte	venti
desarrolla	sviluppa
periodistas	giornalisti
llevan	portano
factores	fattori
salvo	salvo
chica	ragazza
precio	prezzo
pensamiento	pensiero
leer	leggere
declaración	dichiarazione
deportistas	sportivi
mala	cattiva
asesinado	assassinato
asesinado	ucciso
argumento	argomento
online	online
portal	portale
médicos	medici
sacerdote	prete
buenas	buone
cultivo	coltura
nicaragua	nicaragua
regionales	regionali
regionales	regionale
rodrigo	rodrigo
arzobispo	arcivescovo
mancha	macchia
inteligencia	intelligenza
realizan	effettuano
realizan	realizzano
baile	ballo
fundamental	fondamentale
disney	disney
relevante	rilevante
fox	fox
serían	sarebbero
paseo	passeggiata
albert	albert
menciona	menziona
green	green
famosa	famosa
obtiene	ottiene
brian	brian
romero	rosmarino
espera	aspetta
compañías	compagnie
diseñado	progettato
reciente	recente
intereses	interessi
senado	senato
mercedes	mercedes
christian	christian
johnson	johnson
edward	edward
esteban	stefano
videojuego	videogioco
introduction	introduction
coros	cori
vicepresidente	vicepresidente
plantillas	modelli
canarias	canarie
disputa	disputa
ave	uccello
astronómicos	astronomici
post	post
valenciana	valenciana
den	den
orígenes	origini
éstos	questi
económicos	economici
aliados	alleati
rally	rally
detalles	dettagli
detalles	particolari
salto	salto
marine	marine
bilbao	bilbao
rivera	rivera
roger	roger
colonial	coloniale
competiciones	competizioni
dictadura	dittatura
tenga	abbia
medina	medina
difusión	diffusione
alcanza	raggiunge
ejecución	esecuzione
ensayo	prova
lucas	luca
independientes	indipendenti
joan	joan
boston	boston
reglas	regole
viernes	venerdì
golfo	golfo
nobles	nobili
augusto	augusto
radical	radicale
tratar	trattare
yucatán	yucatan
establecido	stabilito
establecido	impostato
bruselas	bruxelles
mandato	mandato
trenes	treni
feria	fiera
comida	cibo
apellido	cognome
etapas	fasi
etapas	tappe
comunas	comuni
seguro	sicuro
fotos	foto
amistad	amicizia
entra	entra
extranjeros	stranieri
artillería	artiglieria
concentración	concentrazione
contar	contare
máquina	macchina
lagos	lagos
montes	monti
hot	hot
usan	usano
fruto	frutto
manual	manuale
coche	macchina
bernardo	bernardo
brasileño	brasiliano
terrenos	terreni
miranda	miranda
ceremonia	cerimonia
columbia	columbia
lejos	lontano
conflictos	conflitti
fallecidos	deceduti
alicante	alicante
pregunta	domanda
drama	dramma
juez	giudice
requiere	richiede
sons	sons
this	this
ala	ala
continental	continentale
continental	continental
endémica	endemica
taylor	taylor
sexo	sesso
presentes	presenti
miami	miami
celebración	celebrazione
day	day
previamente	precedentemente
mínimo	minimo
macdonald	macdonald
milán	milano
tomo	tomo
descenso	discesa
descritos	descritti
viajes	viaggi
bloqueo	blocco
empleados	impiegati
batallas	battaglie
agrupación	raggruppamento
fenómeno	fenomeno
continuar	continuare
continuar	proseguire
continuar	continua
paredes	pareti
jurado	giuria
can	can
tenemos	abbiamo
muñoz	muñoz
permiten	permettono
empleo	occupazione
usos	usi
confederación	confederazione
upper	upper
suárez	suarez
cabezas	teste
misuri	missouri
agrícola	agricolo
agrícola	agricola
continúa	continua
parecer	sembrare
opera	opera
aniversario	anniversario
niña	bambina
terremoto	terremoto
casco	casco
factor	fattore
hollywood	hollywood
suma	somma
oxford	oxford
deseo	desiderio
ejemplares	copie
buque	nave
diciendo	dicendo
siguen	seguono
ausencia	assenza
lanza	lancia
wheeler	wheeler
coalición	coalizione
naves	navi
realización	realizzazione
interna	interno
personalidad	personalità
félix	felix
bill	bill
flor	fiore
jugando	giocando
alas	ali
jardines	giardini
muro	muro
grados	gradi
santuario	santuario
destrucción	distruzione
empresario	imprenditore
entrenamiento	addestramento
entrenamiento	allenamento
propietario	proprietario
nacida	nata
llegan	arrivano
claramente	chiaramente
molina	molina
cañones	cannoni
marie	marie
poseen	possiedono
pasos	fasi
pasos	passaggi
descubrimiento	scoperta
retirada	ritiro
ciclista	ciclista
catálogo	catalogo
revisión	revisione
tarea	compito
extranjero	straniero
anna	anna
divide	divide
divisiones	divisioni
vieja	vecchia
abandonar	abbandonare
espectáculo	spettacolo
organismos	organismi
indios	indiani
journal	journal
irán	iran
grave	grave
héctor	ettore
habana	avana
punk	punk
caracteriza	caratterizza
organismo	organismo
encuentros	incontri
auto	auto
ford	ford
columnas	colonne
clásicos	classici
incluida	inclusa
incluida	compresa
comunicaciones	comunicazioni
elena	elena
productores	produttori
racing	racing
secciones	sezioni
guzmán	guzman
tesis	tesi
conexión	connessione
secretaría	segreteria
bautista	battista
embajada	ambasciata
invitado	ospite
colón	colombo
best	best
tenis	tennis
individuos	individui
publications	publications
finalizar	termina
exposiciones	esposizioni
museos	musei
little	little
explica	spiega
cambridge	cambridge
lectura	lettura
álvaro	alvaro
extiende	estende
quiero	voglio
wiley	wiley
colorado	colorado
transición	transizione
muere	muore
muere	muori
recientes	recenti
consideran	considerano
alguno	alcuno
llamadas	chiamate
cristina	cristina
rutas	itinerari
presentar	presentare
rival	rivale
norma	norma
posesión	possesso
encontraban	trovavano
estudiante	studente
caminos	strade
alcance	portata
laura	laura
pdf	pdf
privado	privato
participado	partecipato
esfuerzo	sforzo
piedras	pietre
capa	mantello
capa	strato
lateral	laterale
editores	editori
daños	danni
ernesto	ernesto
exclusivamente	esclusivamente
magnitud	grandezza
cueva	grotta
alternativa	alternativa
discurso	discorso
activa	attiva
entidades	entità
tareas	compiti
moneda	valuta
relacionado	correlati
aldea	villaggio
soporte	supporto
gloria	gloria
chico	ragazzo
incluir	includere
prado	prato
católico	cattolico
incluía	comprendeva
incluía	includeva
editado	modificato
times	times
caballería	cavalleria
representan	rappresentano
rebelión	ribellione
religiosas	religiose
definitivamente	decisamente
definitivamente	definitivamente
definitivamente	sicuramente
asistente	assistente
fallecido	deceduto
canadiense	canadese
alex	alex
jacques	jacques
ritmo	ritmo
andes	andes
guionista	sceneggiatore
mallorca	maiorca
vocal	vocale
entertainment	entertainment
tío	zio
senador	senatore
relacionadas	correlati
viven	vivono
costas	coste
organizado	organizzato
adultos	adulti
dispone	dispone
partida	partenza
carreteras	strade
declarado	dichiarato
gobiernos	governi
special	special
quito	tolgo
cardenal	cardinale
hermandad	fratellanza
perro	cane
establecimiento	stabilimento
rápida	veloce
dura	dura
capítulos	capitoli
precisamente	appunto
archipiélago	arcipelago
gregorio	gregorio
tocar	toccare
negros	neri
asunto	oggetto
ramas	rami
publica	pubblica
morir	morire
insecto	insetto
ganando	vincendo
cartagena	cartagena
autonomía	autonomia
cocina	cucina
asociado	associato
cualquiera	chiunque
pesca	pescare
sucesión	successione
primo	cugino
avance	avanzamento
proteger	proteggere
presidencial	presidenziale
pacientes	pazienti
finlandia	finlandia
laterales	laterali
estrecho	stretto
ampliamente	ampiamente
determinar	determinare
telenovela	telenovela
fabricación	fabbricazione
poema	poesia
lados	lati
saludo	saluto
recuerda	ricorda
indonesia	indonesia
prentice	prentice
marino	marino
ramos	ramos
ray	ray
batallón	battaglione
gastronomía	cucina
académico	accademico
virus	virus
umbral	soglia
potencial	potenziale
extra	extra
pilar	pilar
pilar	pilastro
utilizados	utilizzati
moral	morale
cierre	chiusura
vargas	vargas
carl	carl
paisaje	paesaggio
noble	nobile
aviación	aviazione
rendimiento	prestazioni
acontecimientos	eventi
escultor	scultore
supuesto	presunto
usada	usata
antigüedad	antichità
penal	penale
davis	davis
sam	sam
recuperar	recuperare
resumen	riassunto
resumen	sommario
medellín	medellín
serbia	serbia
shift	shift
arcos	archi
integrado	integrato
existentes	esistenti
errores	errori
raíces	radici
responsabilidad	responsabilità
cuentan	contano
amenaza	minaccia
ojo	occhio
cero	zero
separación	separazione
pasaron	passarono
convención	convenzione
sciences	sciences
teatral	teatrale
habilidades	abilità
bbc	bbc
pago	pagamento
tendencia	tendenza
animación	animazione
instalación	installazione
marcas	marche
vietnam	vietnam
poca	poca
índice	indice
gana	vince
cambia	cambia
hectáreas	ettari
terror	terrore
próximo	prossimo
saddle	saddle
pena	pena
quizás	forse
realizadas	realizzate
comparación	confronto
producen	producono
habilidad	abilità
define	definisci
tiro	tiro
navarro	navarro
solitario	solitario
wisconsin	wisconsin
cursos	corsi
dioses	dèi
disposición	disposizione
dolor	dolore
num	num
fácilmente	facilmente
boys	boys
magdalena	maddalena
cadenas	catene
serán	saranno
comúnmente	comunemente
serv	serv
tasa	tassa
hecha	fatta
petición	richiesta
notables	notevoli
wiki	wiki
criterios	criteri
out	out
hermanas	sorelle
interpretada	interpretata
disponibles	disponibili
estadística	statistica
game	game
herramientas	strumenti
simón	simon
blackwell	blackwell
gil	gil
escapar	fuga
espada	spada
will	will
árabes	arabi
sexto	sesto
matar	uccidere
ninguno	nessuno
vertical	verticale
oficinas	uffici
kong	kong
contemporánea	contemporanea
disciplina	disciplina
cech	cech
aparecer	apparire
who	who
gigante	gigante
cristiano	cristiano
moyle	moyle
revolucionario	rivoluzionario
obispos	vescovi
blancas	bianche
derrotado	sconfitto
participaciones	partecipazioni
candidatura	candidatura
arthur	arthur
ortiz	ortiz
vegetación	vegetazione
voluntad	volontà
habiendo	avendo
necesidades	bisogni
eliminar	rimuovi
vandalismo	vandalismo
france	france
científicamente	scientificamente
karl	karl
cayó	cadde
clasificado	riservato
clasificado	classificato
ven	vieni
maestros	insegnanti
negocio	affari
mención	menzione
escribe	scrivi
esfuerzos	sforzi
dolores	dolori
dolores	dolores
actuar	agire
producciones	produzioni
andrea	andrea
gris	grigio
periódicos	giornali
oviedo	oviedo
lewis	lewis
margarita	margherita
adicional	addizionale
adicional	supplementare
regresa	ritorna
brigada	brigata
claudio	claudio
graves	graves
quedan	restano
quedan	rimangono
béisbol	baseball
redacción	redazione
junior	junior
tomando	prendendo
depende	dipende
combinación	combinazione
aventuras	avventure
combustible	carburante
combustible	combustibile
eric	eric
inaugurado	inaugurato
ocurrió	accadde
embajador	ambasciatore
dirige	dirige
entender	capire
compra	acquisto
obligado	obbligato
puedes	puoi
involucrados	coinvolti
desierto	deserto
compuestos	composti
lisboa	lisbona
juana	giovanna
electo	eletto
agentes	agenti
creador	creatore
power	power
venecia	venezia
ensayos	prove
barroco	barocco
rev	rev
alba	alba
considerar	considerare
ingenieros	ingegneri
insectos	insetti
pistas	piste
trinidad	trinidad
mamíferos	mammiferi
cinta	nastro
retrato	ritratto
calor	calore
stone	stone
are	are
colonias	colonie
goya	goya
mejora	miglioramento
flandes	fiandre
republicano	repubblicano
lord	lord
míchigan	michigan
twitter	twitter
acompañado	accompagnato
talleres	concessionari
jim	jim
peor	peggiore
peor	peggio
bottom	bottom
anillo	anello
blues	blues
parejas	coppie
basílica	basilica
nieto	nipote
acceder	accedere
hans	hans
terrestre	terrestre
elenco	cast
estrategia	strategia
causas	cause
virtual	virtuale
integración	integrazione
astronómica	astronomica
temporal	temporaneo
contenidos	contenuti
clausura	disattivazione
obteniendo	ottenendo
tenerife	tenerife
útil	utile
lunes	lunedi
lunes	lunedì
grammy	grammy
minuto	minuto
estilos	stili
probable	probabile
estatua	statua
supremo	supremo
equivalente	equivalente
campus	campus
volúmenes	volumi
tomado	preso
estancia	soggiorno
jan	jan
anexos	allegati
matemáticas	matematica
descendientes	discendenti
caballos	cavalli
verdes	verdi
boy	boy
back	back
lara	lara
hidalgo	hidalgo
marruecos	marocco
amiga	amica
hola	ciao
gales	galles
defensor	difensore
tokio	tokyo
sir	sir
quedaron	rimasero
euros	euro
ciclismo	bicicletta
controlar	controllare
alpes	alpi
benito	benedetto
copas	bicchieri
semillas	sementi
pierde	perde
pasión	passione
home	home
variante	variante
acero	acciaio
héroe	eroe
collette	collette
malden	malden
aumentar	aumenta
aumentar	aumentare
adicionales	supplementari
patria	patria
prisioneros	prigionieri
actitud	atteggiamento
borde	orlo
borde	bordo
bibliotecario	bibliotecario
pre	pre
mecánica	meccanica
moda	moda
recuperación	recupero
otoño	autunno
lanzada	liberata
lanzada	lanciata
rebotes	rimbalzi
tienda	negozio
temperaturas	temperature
campañas	campagne
obtenido	ottenuto
nintendo	nintendo
vera	vera
reducir	ridurre
descubrió	scoprì
buscando	cercando
long	long
cárcel	carcere
cuento	racconto
cuento	conto
imposible	impossibile
mencionado	menzionato
mencionado	accennato
prácticas	pratiche
draft	draft
africa	africa
audio	audio
crónica	cronaca
garden	garden
toro	toro
solista	solista
reducción	riduzione
tribu	tribù
registros	registri
ligeramente	leggermente
fotografías	fotografie
nuestros	nostri
congo	congo
presidentes	presidenti
continua	continua
kim	kim
tendría	avrebbe
tendría	avrei
jurisdicción	giurisdizione
candidatos	candidati
dibujos	disegni
dueño	proprietario
escritora	scrittrice
puedo	posso
investigadores	ricercatori
checa	ceca
mérida	merida
bibliografía	bibliografia
ejercicio	esercizio
rioja	rioja
apariencia	aspetto
oferta	offerta
variedades	varietà
ventaja	vantaggio
revela	rivela
peruana	peruviana
remix	remix
libertadores	libertadores
decidieron	decisero
humor	umorismo
influencias	influenze
bomba	pompa
verlag	verlag
sujeto	soggetto
delante	davanti
mostrar	mostra
necesaria	necessaria
adolfo	adolfo
françois	françois
cien	cento
arquitectos	architetti
arkansas	arkansas
cooperación	cooperazione
editar	modifica
alan	alan
monedas	monete
das	das
orientación	orientamento
preparación	preparazione
victor	victor
integrada	integrata
mérito	merito
consenso	consenso
jerusalén	gerusalemme
himno	inno
chrysomelidae	chrysomelidae
cristal	vetro
bella	bella
visual	visivo
visual	visuale
bloque	blocco
presupuesto	bilancio
neptune	neptune
desconocido	sconosciuto
almirante	ammiraglio
eléctrico	elettrico
calendario	calendario
siria	siria
play	play
pensar	pensare
empate	pareggio
tono	suoneria
adn	dna
representado	rappresentato
confianza	fiducia
colecciones	collezioni
exilio	esilio
funciona	funziona
dejado	lasciato
not	not
excelente	eccellente
determinado	determinato
veracruz	veracruz
ido	andato
uruguayo	uruguaiano
publicidad	pubblicità
inauguración	inaugurazione
polaco	polacco
hipótesis	ipotesi
atacar	attaccare
parques	parchi
centrales	centrali
progreso	progresso
nosotros	noi
ávila	ávila
selva	giungla
ibérica	iberica
debían	dovevano
florencia	firenze
elegir	scegli
elegir	scegliere
tripulación	equipaggio
defender	defender
defender	difendere
marcelo	marcelo
secuencia	sequenza
michel	michel
intentar	provare
millas	miglia
situaciones	situazioni
permitir	permetti
permitir	consenti
genérico	generico
samuel	samuele
porcentaje	percentuale
mata	uccide
uniforme	uniforme
satélite	satellite
aventura	avventura
compone	compone
brazo	braccio
sal	sale
body	body
borrar	cancella
ruinas	rovine
observar	osservare
parecido	somiglianza
aceite	olio
playstation	playstation
jaén	jaén
eliminado	eliminato
microsoft	microsoft
ariel	ariel
regla	regola
douglas	douglas
tumba	tomba
empleado	impiegato
belgrano	belgrano
bulgaria	bulgaria
sun	sun
alias	alias
kevin	kevin
venezolano	venezuelano
ideal	ideale
alrededores	dintorni
ingleses	inglesi
mecanismo	meccanismo
wrestling	wrestling
atp	atp
rocas	scogli
trama	trama
renacimiento	rinascita
renacimiento	rinascimento
dama	dama
diputación	diputación
dificultades	difficoltà
daño	danni
seguidores	seguaci
parroquial	parrocchiale
argumentos	argomenti
mauricio	maurizio
inversión	investimento
asociaciones	associazioni
andré	andré
flujo	flusso
tendrá	avrà
eva	eva
italianos	italiani
darle	dargli
conceptos	concetti
realizados	realizzati
east	east
placa	placca
mtv	mtv
rosas	rose
psicología	psicologia
indígena	indigeno
criterio	criterio
fiscal	procuratore
hoja	foglia
hoja	foglio
cuadrados	quadrati
rose	rose
aprendizaje	apprendimento
grabar	registrare
sexta	sesto
sexta	sesta
blog	blog
onda	onda
capaces	capaci
interesante	interessante
abc	abc
reformas	riforme
encontraron	trovarono
esposo	marito
fenner	fenner
gray	gray
variantes	varianti
luisa	luisa
representar	rappresentare
publicados	pubblicati
old	old
creando	creando
respeto	rispetto
correo	posta
destinado	destinato
eliminación	eliminazione
símbolos	simboli
cerámica	ceramica
delgado	sottile
asentamiento	insediamento
guadalupe	guadalupa
variable	variabile
tecnologías	tecnologie
abre	apri
griegos	greci
caracteres	caratteri
llevaba	portava
grabaciones	registrazioni
petróleo	petrolio
intercambio	scambio
aviso	avviso
psoe	psoe
absoluta	assoluta
absoluta	assoluto
dónde	dove
vendido	venduto
unirse	unirsi
famosos	celebrità
duro	duro
compitió	gareggiato
arizona	arizona
cristianismo	cristianesimo
huevos	uova
dibujo	disegno
frío	freddo
concreto	calcestruzzo
tradicionalmente	tradizionalmente
decisiones	decisioni
esculturas	sculture
tango	tango
patio	cortile
conocimientos	conoscenze
angel	angelo
administrativo	amministrativo
añadir	aggiungi
dúo	duetto
adam	adam
brillante	brillante
brillante	geniale
reconocida	riconosciuta
existía	esisteva
leche	latte
nápoles	napoli
caer	cadere
pagar	pagare
soldado	soldato
teorías	teorie
jose	jose
puertos	porti
cincuenta	cinquanta
salta	salta
ribera	ribera
almería	almeria
croacia	croazia
tormenta	tempesta
transformación	trasformazione
ejércitos	eserciti
genera	genera
cáceres	cáceres
rebeldes	ribelli
visitantes	visitatori
colo	colo
cabrera	cabrera
ropa	abbigliamento
propuesto	proposto
máquinas	macchine
acabar	rifinire
síndrome	sindrome
soledad	solitudine
localizado	localizzato
localizado	individuato
tiendas	negozi
premier	premier
cuello	collo
trataba	trattava
nick	nick
propuestas	proposte
orientales	orientali
asalto	assalto
procesión	processione
democrático	democratico
compromiso	impegno
palacios	palazzi
consecuencias	conseguenze
ranking	classifica
mateo	matteo
abuelo	nonno
propuso	propose
quizá	forse
núñez	núñez
novia	sposa
novia	fidanzata
contienen	contengono
tucumán	tucumán
utilización	utilizzo
utilización	utilizzazione
filas	righe
anexo	allegato
heridos	feriti
activos	attivi
viva	viva
quince	quince
quince	quindici
minerales	minerali
miedo	paura
colombiana	colombiana
vapor	vapore
parecen	sembrano
nazi	nazista
comenzar	iniziare
servir	servire
death	death
alimentación	alimentazione
navidad	natale
promover	promuovere
aprobación	approvazione
intelectual	intellettuale
luchar	lottare
luchar	combattere
traslado	trasferimento
navegación	navigazione
pertenecen	appartengono
desaparición	scomparsa
resolver	risolvere
andrew	andrew
cuentas	conti
desaparecidos	scomparsi
desaparecidos	mancanti
lluvia	pioggia
interno	interno
tradiciones	tradizioni
académicos	accademici
dispositivos	dispositivi
creciente	crescente
marcador	segnalibro
celebrado	celebrato
lady	lady
crucero	crociera
apariciones	apparizioni
pesos	pesi
ocupar	occupare
videos	video
directora	direttore
road	road
coste	costo
realizando	effettuando
polo	polo
sporting	sporting
nebraska	nebraska
medias	calze
proteínas	proteine
eurovisión	eurovision
fundadores	fondatori
maya	maya
bruce	bruce
coruña	coruña
girl	girl
depresión	depressione
firmado	firmato
clientes	clienti
barra	barra
destruir	distruggere
mente	mente
limitada	limitata
relatos	racconti
estamos	siamo
sesión	sessione
protagonistas	protagonisti
tribus	tribù
cientos	centinaia
siglas	sigle
siglas	acronimi
teclados	tastiere
union	union
daba	davo
daba	dava
invitados	invitati
invitados	ospiti
carbono	carbonio
históricas	storiche
johnny	johnny
sony	sony
wild	wild
plazas	piazze
leonardo	leonardo
prefectura	prefettura
específicamente	specificamente
occidentales	occidentali
existente	esistente
techo	tetto
implica	coinvolge
implica	implica
doctorado	dottorato
comando	comando
jimmy	jimmy
incendio	incendio
intentos	tentativi
cae	cade
hitler	hitler
cuestiones	questioni
marta	marta
culturas	culture
costumbres	abitudini
riqueza	ricchezza
largas	lunghe
altar	altare
triple	triplice
triple	tripla
triple	triplo
infraestructura	infrastrutture
infraestructura	infrastruttura
dispositivo	dispositivo
frutos	frutti
derrotar	sconfiggere
josep	josep
what	what
song	song
solicitud	richiesta
silla	sedia
informática	informatica
fronteras	confini
bartolomé	bartolomeo
construcciones	costruzioni
maíz	granturco
emmy	emmy
johann	johann
system	system
gato	gatto
azúcar	zucchero
sueco	svedese
albacete	albacete
millón	milione
defunción	decesso
disputar	disputare
lesión	infortunio
sonidos	suoni
salvar	salvare
atlanta	atlanta
nobel	nobel
friedrich	friedrich
composiciones	composizioni
individuo	individuo
dividido	diviso
alcalá	alcalá
men	men
trece	tredici
crimen	delitto
first	first
correcto	corretto
esclavos	schiavi
aguilar	aguilar
vuelos	voli
abrir	apri
conocen	conoscono
largos	lunghi
valparaíso	valparaiso
inmediato	immediato
interpreta	interpreta
aparentemente	apparentemente
trujillo	trujillo
procedimiento	procedura
album	album
comienzan	cominciano
comienzan	iniziano
periodismo	giornalismo
sábado	sabato
cuartel	caserma
héroes	eroi
elizabeth	elisabetta
perspectiva	prospettiva
cuevas	grotta
correspondientes	corrispondenti
suprema	suprema
decoración	decorazione
hijas	figlie
julián	giuliano
paraná	paraná
gama	gamma
inc	inc
foro	tribuna
copia	copia
muros	muri
articulo	articolo
retorno	ritorno
sands	sands
verse	vedersi
lógica	logica
soto	soto
segura	sicura
cuarenta	quaranta
costo	costo
extinción	estinzione
típico	tipico
nativos	nativi
conferencias	conferenze
ajedrez	scacchi
habitación	camera
señales	segnali
trabajado	lavorato
tensión	tensione
cesar	cesare
conciencia	coscienza
seminario	seminario
juárez	juarez
técnicos	tecnici
palmas	palme
vidas	vite
órganos	organi
cobertura	copertura
jefes	capi
gusta	piace
acaba	finisce
entradas	biglietti
pelo	capelli
estatus	status
monterrey	monterrey
creció	crebbe
miller	miller
contemporáneo	contemporaneo
turístico	turistico
seco	asciutto
howard	howard
lisa	lisa
huracán	uragano
cumbre	vertice
mexicanos	messicani
residentes	residenti
patrick	patrick
conservador	conservatore
rueda	ruota
botánicos	botanici
valles	valli
raión	raën
completar	completare
pacto	patto
llamar	chiamare
contribuciones	contributi
opiniones	opinioni
segovia	segovia
brazos	braccia
british	british
moore	moore
consejero	consigliere
cámaras	fotocamere
website	website
interpretar	interpretare
isidro	isidro
off	off
empezaron	iniziarono
empezaron	cominciarono
documentación	documentazione
autopista	autostrada
arts	arts
circunstancias	circostanze
parcial	parziale
clan	clan
incluidos	inclusi
séptimo	settimo
juniors	juniors
historial	cronologia
billy	billy
impuestos	tasse
reloj	orologio
delta	delta
pardo	pardo
singles	singles
extremadura	estremadura
intensidad	intensità
toronto	toronto
definir	definire
definir	definisci
liberales	liberali
gabinete	gabinetto
fray	frate
equilibrio	equilibrio
esquina	angolo
allen	allen
recuerdo	ricordo
japoneses	giapponesi
inmigrantes	immigrati
pared	parete
henri	henri
órbita	orbita
aceptado	accettata
aceptado	accettato
tropicales	tropicali
designados	designati
gótico	gotico
cima	vetta
elevado	elevato
airlines	airlines
conservan	conservano
vázquez	vázquez
perdiendo	perdendo
soviético	sovietica
soviético	sovietico
rubén	rubén
anthony	anthony
pos	pos
goleador	capocannoniere
atletismo	atletica
heavy	heavy
silencio	silenzio
trofeo	trofeo
was	was
dicen	dicono
ocupado	occupato
arqueológico	archeologico
pobres	poveri
reconstrucción	ricostruzione
tratados	trattati
particulares	privati
presa	preda
oportunidades	opportunità
nevada	nevada
usados	usati
calderón	calderón
monarquía	monarchia
percusión	percussioni
aceptó	accettò
circular	circolare
lobo	lupo
biología	biologia
móvil	mobile
dividida	divisa
víctima	vittima
podrá	potrà
teología	teologia
nobleza	nobiltà
cultivos	colture
considerados	considerati
escultores	scultori
gusto	gusto
corporación	corporation
corporación	corporazione
gimnasia	ginnastica
refugio	rifugio
automóvil	automobile
formaron	formarono
renuncia	rinuncia
borbón	borbone
voy	vado
open	open
jugado	giocato
filósofo	filosofo
cantar	cantare
end	end
decía	diceva
pino	pino
pamplona	pamplona
sofía	sofia
lucía	lucia
antioquia	antioquia
ortega	ortega
absoluto	assoluto
herramienta	strumento
águila	aquila
camiseta	maglia
registrado	registrato
cabello	capelli
reinos	regni
mix	mix
permiso	permesso
musulmanes	musulmani
diversidad	diversità
andy	andy
testamento	testamento
sudeste	sudest
alfred	alfred
cortos	corti
julia	giulia
fracaso	fallimento
vélez	vélez
ciento	ciento
superar	superare
drogas	droghe
fans	fan
persecución	inseguimento
centenario	centenario
mac	mac
consideraba	considerava
cuerdas	corde
selecciones	selezioni
anti	anti
artificial	artificiale
nominaciones	nomination
bay	bay
villanueva	villanueva
muestras	campioni
tomaron	presero
like	like
pertenecía	apparteneva
obrero	operaio
issn	issn
demócrata	democratico
traducido	tradotto
cerebro	cervello
sombra	ombra
mercados	mercati
iniciar	avvia
toneladas	tonnellate
indican	indicano
senadores	senatori
cambiado	cambiato
ganadería	allevamento
deuda	debito
dark	dark
chilenos	cileni
bell	bell
ciclistas	ciclisti
fuertemente	fortemente
secundarios	secondari
proporciona	fornisce
vientos	venti
experimental	sperimentale
bancos	banche
seleccionado	selezionato
indio	indiano
dudas	dubbi
vieron	videro
partículas	particelle
cali	cali
parcialmente	parzialmente
dirigir	dirigere
bravo	bravo
específico	specifico
country	country
pastor	pastore
iván	ivan
traje	tuta
traje	abito
flag	flag
monarca	monarca
cifra	cifra
murieron	morirono
profesora	insegnante
circulación	circolazione
formal	formale
gobernación	governatorato
cerrado	chiuso
detalle	dettaglio
tim	tim
desaparecido	scomparso
sucede	succede
sucede	accade
simpson	simpson
citado	citato
pekín	pechino
yugoslavia	jugoslavia
meta	traguardo
vegas	vegas
ampliación	allargamento
ibn	ibn
doctrina	dottrina
dead	dead
cobre	rame
separado	separato
habitualmente	abitualmente
créditos	crediti
coral	corallo
creados	creati
posibilidades	possibilità
paciente	paziente
arias	arias
great	great
memorias	memorie
tailandia	thailandia
pobre	povero
telenovelas	telenovelas
pasan	passano
velasco	velasco
precios	prezzi
talento	talento
virrey	viceré
frecuentes	comune
captura	cattura
cervantes	cervantes
próxima	prossima
antena	antenna
parada	fermata
dientes	denti
reemplazado	sostituito
marvel	marvel
epíteto	epiteto
heart	heart
retirarse	ritirarsi
temática	tematica
republicana	repubblicana
marcado	marcatura
puentes	ponti
volcán	vulcano
mora	mora
beneficios	profitti
beneficios	benefici
rodolfo	rodolfo
reproducción	riproduzione
sudamericano	sudamericano
platino	platino
field	field
gala	gala
charlie	charlie
hockey	hockey
fósiles	fossili
presentaciones	presentazioni
tablas	tavole
representaciones	rappresentanze
ofensiva	offensiva
rector	rettore
roy	roy
coches	automobili
unesco	unesco
designación	designazione
incidente	incidente
alicia	alice
abogados	avvocati
funcionarios	funzionari
esperar	attendere
atlas	atlante
russell	russell
rumbo	rotta
cruces	croci
negras	neri
rumania	romania
magazine	magazine
exactamente	esattamente
mira	guarda
leo	leggo
opciones	opzioni
alcaldes	sindaci
cortés	cortese
legislativo	legislativo
oliver	oliver
fortuna	fortuna
nova	nova
localizada	localizzate
localizada	localizzato
localizada	localizzata
legislación	legislazione
soria	soria
warner	warner
ramal	diramazione
privadas	privati
privadas	private
last	last
bernard	bernard
rené	rené
matt	matt
instrucción	istruzione
lanzar	lanciare
modalidad	modalità
accidentes	incidenti
adecuado	adeguato
adecuado	adatto
poseía	possedeva
plena	piena
emitido	emesso
delegación	delegazione
sudamericana	sudamericana
sugiere	suggerisce
palencia	palencia
conforme	conforme
apoyar	sostenere
casada	sposata
misa	messa
reconoce	riconosce
marrón	marrone
value	value
relevantes	pertinenti
relevantes	rilevanti
magia	magia
núcleos	nuclei
vender	vendere
simples	semplici
houston	houston
hard	hard
part	part
siguieron	seguirono
participan	partecipano
dorado	dorato
celular	cellulare
ryan	ryan
armando	armando
diarios	quotidiani
directiva	direttiva
armenia	armenia
mina	mina
mina	miniera
gráfico	grafico
amateur	amatoriali
amateur	amatoriale
consultado	consultato
cuál	quale
gracia	grazia
franklin	franklin
viuda	vedova
salazar	salazar
pirineos	pirenei
acta	acta
evidente	evidente
rescate	salvataggio
aceptar	accettare
actúa	agisci
actúa	agisce
relieve	rilievo
considerable	considerevole
integral	integrale
organizar	organizzare
organizar	organizza
infante	infante
reducido	ridotto
athletic	athletic
paula	paula
sobrino	nipote
come	mangia
guayaquil	guayaquil
perros	cani
cliente	cliente
profundo	profondo
ruedas	ruote
tantos	tanti
modificaciones	modifiche
fontsize	fontsize
inmigración	immigrazione
aguirre	aguirre
arqueológicos	archeologici
channel	channel
down	down
asociados	associati
asociados	soci
mariscal	maresciallo
naranja	arancione
autobuses	autobus
embalse	bacino
americanos	americani
rayos	raggi
ducado	ducato
aficionados	dilettanti
representada	rappresentata
condados	contee
marc	marc
gordon	gordon
multitud	folla
heredero	erede
generar	generare
cubre	copre
finalista	finalista
cátedra	cattedra
licenciado	laureato
licenciado	congedato
espiritual	spirituale
page	page
basados	basati
violín	violino
carnaval	carnevale
fort	fort
playas	spiagge
síntesis	sintesi
way	way
aceptadas	accettati
aceptadas	accettate
piragüismo	canoa
clark	clark
sacerdotes	sacerdoti
dirigentes	dirigenti
shorts	shorts
basadas	basate
evaluación	valutazione
inaugurada	inaugurata
modos	modalità
inscripción	iscrizione
homónimo	omonimo
descubrir	scoprire
enfoque	focus
enfoque	approccio
anne	anne
industrias	industrie
mejoras	miglioramenti
publicar	pubblicare
judío	ebreo
abadía	abbazia
vándalo	vandalo
crédito	accreditamento
crédito	credito
pedir	chiedere
pedir	ordinare
irak	iraq
roque	roque
queen	queen
visitante	visitatore
fundados	fondate
fundados	fondati
deberían	dovrebbero
institucional	istituzionale
operador	operatore
investigador	ricercatore
negociaciones	negoziati
negociaciones	trattative
marítimo	marittimo
serrano	serrano
inclinación	inclinazione
federales	federali
judía	fagiolo
escritas	scritte
amante	amante
wayne	wayne
holanda	olanda
arroz	riso
dificultad	difficoltà
sicilia	sicilia
dave	dave
sustituido	sostituito
secundario	secondario
hilo	filo
belga	belga
operativo	operativo
épocas	periodi
terminado	finito
propone	propone
extensa	vasta
cabildo	cabildo
dragón	drago
organizada	organizzata
ofrecer	offrire
armamento	armamenti
profunda	profonda
profunda	profondo
napoleón	napoleone
link	link
recepción	ricezione
parroquias	parrocchie
igualdad	uguaglianza
conductor	conducente
orleans	orleans
krasnodar	krasnodar
sabor	sapore
síntomas	sintomi
detenido	arrestato
legión	legione
golden	golden
alcanzado	raggiunta
alcanzado	raggiunto
licenciatura	laurea
elegidos	eletti
vale	vale
pabellón	bandiera
christopher	christopher
springer	springer
jason	jason
missouri	missouri
surge	sorge
baviera	baviera
soberanía	sovranità
expertos	esperti
necesarios	necessari
alaska	alaska
asesino	assassino
prima	cugina
manifestaciones	manifestazioni
bolsa	borsa
dedica	dedica
elegida	prescelta
masas	masse
paralelo	parallelo
empezar	iniziare
demostrar	dimostrare
demostrado	dimostrato
fragmentos	frammenti
acuerdos	accordi
disputado	contestato
ballet	balletto
wikimedia	wikimedia
moon	moon
viajar	viaggiare
toros	tori
escenarios	scenari
crece	cresce
anuales	annuali
diálogo	dialogo
lema	motto
observa	osserva
informó	segnalati
diplomático	diplomatico
malasia	malesia
adams	adams
marinos	marinai
socio	partner
lingüística	linguistica
condesa	contessa
mencionar	citare
mencionar	menzionare
ross	ross
jerónimo	girolamo
version	version
cumple	soddisfa
identificación	identificazione
good	good
asegurar	assicurare
electricidad	elettricità
sesiones	sessioni
tránsito	transito
típica	tipica
robin	robin
filial	filiale
atmósfera	atmosfera
madonna	madonna
explicar	spiegare
hacían	facevano
colectivo	collettivo
vacío	vuoto
requisitos	requisiti
movie	movie
pontificia	pontificia
diana	diana
únicos	unici
elevada	elevata
nieve	neve
pares	coppie
comunistas	comunisti
colina	collina
cuerda	corda
espectáculos	spettacoli
señores	signori
aplica	applica
promocional	promozionale
chicas	ragazze
vizcaya	biscaglia
jane	jane
sentimientos	sentimenti
aparato	apparecchio
variables	variabili
project	project
poderoso	potente
nacionalista	nazionalista
pudiendo	potendo
alcanzando	raggiungendo
provisional	provvisorio
jeff	jeff
barón	barone
salinas	salinas
venganza	vendetta
sajonia	sassonia
socks	socks
official	official
clínica	clinica
harvard	harvard
observación	osservazione
bajista	bassista
explosión	esplosione
bruno	bruno
armado	armato
aux	aux
acusado	accusato
mínima	minima
renovación	rinnovo
diosa	dea
acepta	accetta
ventana	finestra
rusos	russi
reservas	prenotazioni
variaciones	variazioni
ventanas	finestre
sat	sat
beneficio	profitto
descarga	scarica
visitar	visitare
herencia	eredità
gijón	gijón
juntas	insieme
aeronaves	aeromobili
madagascar	madagascar
extremos	estremità
extremos	estremi
plato	piatto
eugenio	eugenio
claude	claude
dir	dir
añade	aggiunge
instrumental	strumentale
gravedad	gravità
competir	competere
ferrocarriles	ferrovie
líquido	liquido
pozo	pozzo
plataformas	piattaforme
jonathan	jonathan
pecho	torace
pecho	petto
constelación	costellazione
explicación	spiegazione
conclusión	conclusione
prestigio	prestigio
campesinos	contadini
kelly	kelly
story	story
aumenta	aumenta
biblia	bibbia
seria	seria
antología	antologia
inspiración	ispirazione
negativa	negativo
impresión	stampa
fría	fredda
spring	spring
diseños	disegni
teléfono	telefono
pío	pio
ideología	ideologia
costumbre	abitudine
patricia	patrizia
georges	georges
cómic	fumetto
ball	ball
logros	realizzazioni
comprar	comprare
enterrado	sepolto
herido	ferito
cubierto	coperto
mental	mentale
franz	franz
polémica	polemica
crónicas	cronache
principado	principato
alegre	gioiosa
relativa	relativa
suelos	pavimenti
destacando	sottolineando
destacando	evidenziando
parecía	sembrava
oaxaca	oaxaca
consiguiendo	ottenendo
recurso	risorsa
rubio	bionda
rubio	biondo
homónima	omonima
méndez	méndez
vivían	vivevano
vela	vela
creek	creek
chávez	chavez
voleibol	pallavolo
conjuntos	insiemi
demuestra	dimostra
rolling	rolling
competencias	competenze
talla	taglia
bafta	bafta
personalidades	personalita
experiencias	esperienze
austin	austin
sesenta	sessanta
cannes	cannes
litoral	litorale
fases	fasi
orgánica	organici
orgánica	organico
franja	striscia
book	book
hemos	abbiamo
piensa	pensa
piensa	rifletti
carbón	carbone
mozart	mozart
set	set
sufre	soffre
vocales	vocali
perdidos	persi
perdidos	perduti
pesado	pesante
sorpresa	sorpresa
cruce	incrocio
descendencia	discendenza
badajoz	badajoz
bárbara	barbara
romance	romanticismo
escuadrón	squadrone
brasileña	brasiliana
oxígeno	ossigeno
distinto	diverso
jueves	giovedi
jueves	giovedì
cráter	cratere
distinción	distinzione
abandonado	abbandonato
nominación	nomination
instancia	istanza
reuniones	riunioni
mármol	marmo
instrucciones	istruzioni
tengan	abbiano
pascual	pasquale
jalisco	jalisco
matemática	matematica
muralla	muraglia
cura	cura
disolución	dissoluzione
disolución	scioglimento
vivía	viveva
hispano	ispanico
señorío	signoria
interpretando	interpretando
milenio	millennio
ligero	leggero
sagrado	sacro
empresarios	imprenditori
húngaro	ungherese
matriz	matrice
books	books
sara	sara
valley	valley
marshall	marshall
pase	pass
wilhelm	wilhelm
coordinación	coordinazione
coordinación	coordinamento
sarmiento	sarmiento
perteneció	apparteneva
condenado	condannato
caliente	caldo
reúne	riunisce
represión	repressione
deciden	decidono
hembras	femmine
corredor	corridoio
corredor	corridore
radiación	radiazione
rostro	viso
baker	baker
bad	bad
mexico	messico
tito	tito
point	point
corporation	corporation
construyeron	costruirono
ine	ins
estética	estetica
visitas	visite
otto	otto
colonos	coloni
configuración	impostazioni
boda	matrimonio
boda	nozze
gobernadores	governatori
ganados	vinti
permitía	consentiva
entiendo	capisco
crearon	crearono
mecanismos	meccanismi
entrantes	antipasti
trasladado	trasferito
construidos	costruiti
gen	gen
lleno	pieno
colaborador	collaboratore
sentencia	sentenza
varones	maschi
congregación	congregazione
incorpora	incorpora
abandono	abbandono
clasificados	classificati
trazado	tracciato
kennedy	kennedy
subsp	subsp
defensores	difensori
gay	gay
check	check
sueños	sogni
vamos	andiamo
anualmente	annualmente
asentamientos	insediamenti
lector	lettore
básicamente	fondamentalmente
puntuación	punteggio
conducta	comportamento
ángulo	angolo
oral	orale
precisión	precisione
protegido	protetto
recomienda	raccomanda
representando	rappresentando
socialistas	socialisti
atraviesa	attraversa
postura	postura
provoca	provoca
sarah	sarah
socios	partner
socios	soci
oración	preghiera
arteria	arteria
pri	pri
protegidas	protette
amazonas	amazzoni
visible	visibile
grant	grant
templos	templi
anfibios	anfibi
islam	islam
adyacentes	adiacenti
geográfico	geografico
misiles	missili
tejido	tessuto
aprobado	approvato
studios	studios
apodo	soprannome
emergencia	emergenza
intérprete	interprete
canta	canta
constantemente	costantemente
limitado	limitato
nombrada	nominata
enviar	invia
soul	soul
intendente	intendente
preguntas	domande
wwe	wwe
memorial	memorial
memorial	memoriale
estadios	stadi
reciben	ricevono
vigilancia	sorveglianza
planificación	pianificazione
bibliotecarios	bibliotecari
montreal	montréal
barrera	barriera
permitiendo	permettendo
aprender	imparare
actualización	aggiornamento
pictures	pictures
pakistán	pakistan
catalunya	catalunya
baby	baby
tesoro	tesoro
macedonia	macedonia
ali	ali
ofrecen	offrono
pianista	pianista
facilitar	facilitare
bits	bit
presidenciales	presidenziali
maestra	insegnante
sancho	sancho
continuo	continuo
continuo	continuum
exploración	esplorazione
consejos	consigli
parámetros	parametri
legado	eredità
chicos	ragazzi
guitarras	chitarre
componente	componente
corrupción	corruzione
ebro	ebro
vegetales	verdure
lawrence	lawrence
dragon	dragon
séptima	settima
signo	segno
espejo	specchio
finalidad	finalità
iso	iso
sinfonía	sinfonia
virtud	virtù
teclado	tastiera
matemático	matematico
feliz	felice
recoge	raccoglie
recoge	raccogli
mapas	mappe
molecular	molecolare
cúpula	cupola
ciudadano	cittadino
cónsul	console
somos	siamo
existir	esistere
protocolo	protocollo
malvinas	falkland
dallas	dallas
capturado	catturato
cerrada	chiusa
huesca	huesca
célebre	celebre
batman	batman
continuidad	continuità
francesas	francesi
hablando	parlando
asesor	consulente
restaurante	ristorante
tanques	serbatoi
informes	relazioni
misterio	mistero
harris	harris
division	division
expresa	espressa
expresa	esprime
planetas	pianeti
proteína	proteina
espalda	schiena
postal	cartolina
signos	segni
administrador	amministratore
noches	notti
estrecha	stretta
extraño	strano
tratando	trattando
vigo	vigo
mantienen	mantengono
venus	venere
determinada	determinata
hamilton	hamilton
escaños	seggi
cirugía	chirurgia
chinos	cinese
chinos	cinesi
segmento	segmento
destruido	distrutto
ayudante	assistente
servidor	server
portero	portiere
característico	caratteristico
aplicar	applicare
perfectamente	perfettamente
diablo	diavolo
repertorio	repertorio
viviendo	vivendo
java	java
transferencia	trasferimento
quinteto	quintetto
reconocer	riconoscere
more	more
intérpretes	interpreti
llena	piena
jueces	giudici
alcohol	alcol
dejaron	lasciarono
cubano	cubano
rodeado	circondato
beatriz	beatrice
estable	stabile
about	about
inspirado	ispirato
entera	intero
uci	uci
concesión	concessione
arqueología	archeologia
iniciales	iniziali
alimento	alimento
corre	corri
praga	praga
tigre	tigre
linux	linux
light	light
protesta	protesta
ochenta	ottanta
detener	fermare
genética	genetica
monumental	monumentale
responde	rispondi
lyon	lione
celebran	festeggiano
palo	bastone
varía	varia
cat	cat
ondas	onde
sufrido	sofferto
protestas	proteste
contratado	assunto
manteniendo	mantenendo
abundante	abbondante
altamente	altamente
llaman	chiamano
hechas	fatte
conservatorio	conservatorio
correcta	corretta
patricio	patrizio
colonización	colonizzazione
islandia	islanda
controversia	controversia
incorporación	incorporazione
diseñador	progettista
diseñador	designer
tarjeta	scheda
oklahoma	oklahoma
orlando	orlando
anillos	anelli
leyendas	leggende
morgan	morgan
contribución	contributo
banderas	bandiere
originario	originario
acb	acb
voluntarios	volontari
germán	germán
vegetal	vegetale
versos	versi
indicar	indicare
transportes	trasporti
domínguez	dominguez
sustitución	sostituzione
ejercer	esercitare
horacio	orazio
distinciones	distinzioni
literalmente	letteralmente
gráfica	grafica
emisiones	emissioni
supuestamente	presumibilmente
perdieron	persero
western	western
isaac	isacco
bosnia	bosnia
químico	chimico
destinos	destinazioni
partidarios	sostenitori
urss	urss
reacciones	reazioni
challenger	challenger
queso	formaggio
leopoldo	leopoldo
ponce	ponce
externo	esterno
silvestre	selvatica
gary	gary
inca	inca
identificar	identificare
ian	ian
hip	hip
smiths	smiths
concilio	concilio
escuchar	ascoltare
hop	hop
catorce	quattordici
legales	legali
his	his
representó	rappresentava
pelota	palla
gráficos	grafica
ferrer	ferrer
taiwán	taiwan
natación	nuoto
frases	frasi
anuncio	inserzione
azules	azzurri
tubo	tubo
freshwater	freshwater
flamenco	flamenco
refleja	riflette
cálculo	calcolo
get	get
cifras	cifre
carter	carter
orange	orange
quebec	quebec
kentucky	kentucky
lorena	lorena
entrevistas	interviste
futura	futura
bibliotecas	biblioteche
propietarios	proprietari
hierba	erba
detroit	detroit
responsables	responsabili
convenciones	convenzioni
extremadamente	estremamente
toca	tocca
cubana	cubana
hernán	hernan
hablan	parlano
abad	abate
consistía	consisteva
químicos	chimici
publicadas	pubblicate
iniciado	iniziato
manifiesto	manifesto
fantasma	fantasma
centímetros	centimetri
commons	commons
soluciones	soluzioni
revuelta	rivolta
implicados	coinvolti
regulares	regolari
especialidad	specialità
contraste	contrasto
castellón	castellón
carlo	carlo
generaciones	generazioni
bello	bello
esencial	essenziale
town	town
nombramiento	nomina
jerez	jerez
abreviado	abbreviato
esquema	schema
piratas	pirati
sirven	servono
ecuación	equazione
permanecer	rimanere
recibiendo	ricevendo
faro	faro
jon	jon
phil	phil
almacenamiento	stoccaggio
especializado	specializzato
tarragona	tarragona
asignado	assegnato
fire	fire
neutral	neutrale
tienes	hai
walker	walker
conversión	conversione
separados	separati
omar	omar
descanso	riposo
sinónimo	sinonimo
violación	stupro
presidenta	presidentessa
desempeño	performance
clemente	clemente
presentador	conduttore
quintana	quintana
utah	utah
platos	piatti
débil	debole
vidrio	vetro
casarse	sposarsi
broadway	broadway
trabajaba	lavoravo
trabajaba	lavorava
reseña	recensione
desarrollada	sviluppata
crímenes	crimini
valdés	valdés
free	free
vila	vila
derivados	derivati
chihuahua	chihuahua
contando	contando
vasca	basca
vivos	vivi
gerardo	gerardo
australiano	australiano
seguía	seguivo
asteroide	asteroide
superfamilia	superfamiglia
dimensión	dimensione
atentado	attentato
creía	credeva
afganistán	afghanistan
restaurantes	ristoranti
perry	perry
comer	mangiare
heridas	ferite
diagnóstico	diagnosi
asedio	assedio
montana	montana
privados	privati
onu	onu
modernas	moderne
celebrar	festeggiare
celebrar	celebrare
simultáneamente	simultaneamente
collection	collection
intelectuales	intellettuali
macho	maschio
alumno	studente
steven	steven
reemplazo	sostituzione
décimo	decimo
setenta	settanta
clasificaciones	classifiche
bach	bach
viña	vigna
capas	strati
interacción	interazione
murray	murray
perfecto	perfetto
mhz	mhz
permitido	permesso
permitido	consentito
jordi	jordi
girls	girls
universitarios	universitari
trigo	frumento
persa	persiano
tennessee	tennessee
civilización	civiltà
complejos	complessi
argentinas	argentine
mariana	mariana
turco	turco
creen	credono
enfrentamientos	scontri
iluminación	illuminazione
convocado	convocato
participando	partecipando
mineral	minerale
sustancias	sostanze
entero	intero
impulso	impulso
computadora	computer
computadora	calcolatore
lectores	lettori
castellana	castellana
elevación	elevazione
elevación	sollevamento
integra	integra
rotación	rotazione
estabilidad	stabilità
dependiente	dipendente
curva	curva
alabama	alabama
maestría	perizia
centra	centra
hidrógeno	idrogeno
people	people
criminal	criminale
year	year
vuelto	tornato
tejidos	tessuti
fabricante	produttore
fabricante	fabbricante
cortometraje	cortometraggio
adquisición	acquisizione
cuadrado	quadrato
israelí	israeliano
existían	esistevano
expulsado	espulso
guerreros	guerrieri
positivo	positivo
iguales	uguali
impuesto	imposta
modificación	modifica
haría	farei
haría	farebbe
ginebra	ginevra
luces	luci
interiores	interni
historieta	fumetto
esperaba	aspettavo
esperaba	speravo
sindicato	sindacato
períodos	periodi
masculina	maschile
inclusión	inclusione
rick	rick
suspensión	sospensione
desplazamiento	spostamento
reconocidos	riconosciuti
proporcionar	fornire
berlin	berlino
pedido	ordine
históricamente	storicamente
font	font
específica	specifica
jordan	jordan
huelga	sciopero
centrocampista	centrocampista
eddie	eddie
claudia	claudia
apple	apple
benjamin	benjamin
capitales	capitali
sostiene	sostiene
adecuada	adeguata
just	just
huesos	ossa
llamaba	chiamava
vídeos	video
serena	serena
declarada	dichiarata
unam	unam
salsa	salsa
salvaje	selvaggio
baleares	baleari
bryan	bryan
alfabeto	alfabeto
continuaron	continuarono
japan	japan
manuscrito	manoscritto
petersburgo	pietroburgo
horizontal	orizzontale
vestido	vestito
especializada	specializzata
octavo	ottavo
palestina	palestina
cartel	manifesto
maryland	maryland
arm	arm
espero	spero
granja	fattoria
patas	zampe
heemstra	heemstra
vanguardia	avanguardia
presentada	depositata
masters	masters
préstamo	prestito
plate	plate
estatuto	statuto
dream	dream
liderazgo	leadership
mostrando	mostrando
space	space
célula	cellula
lineal	lineare
franquicia	franchigia
franquicia	franchising
tervuren	tervuren
expulsión	espulsione
linda	linda
genes	geni
nicolas	nicolas
perón	perón
observaciones	osservazioni
desembocadura	foce
pepe	pepe
rivales	rivali
alice	alice
rayo	raggio
físicos	fisici
organiza	organizza
bombas	pompe
maurice	maurice
cecilia	cecilia
marte	marte
retratos	ritratti
loco	pazzo
harrison	harrison
stewart	stewart
formalmente	formalmente
argelia	algeria
sound	sound
novio	fidanzato
rechazo	rifiuto
parker	parker
eligió	scelse
firmar	firmare
describir	descrivere
fichó	giallorossa
xavier	xavier
chipre	cipro
guy	guy
expresiones	espressioni
ruptura	rottura
emisora	emittente
filósofos	filosofi
previsto	previsto
thys	thys
adolescente	teen
inés	agnese
actualizado	aggiornato
prototipo	prototipo
dinámica	dinamica
variación	variazione
latitud	latitudine
trío	trio
usted	lei
sabía	sapevo
sabía	sapeva
alfa	alfa
caudal	portata
ann	ann
irlandés	irlandese
asiático	asiatico
edgar	edgar
anchura	larghezza
botanical	botanical
barry	barry
utilidad	utilità
manchester	manchester
beatles	beatles
higgins	higgins
celebrada	celebrata
receptor	ricevitore
construidas	costruite
personalmente	personalmente
prólogo	prefazione
valenciano	valenciano
xbox	xbox
force	force
contemporáneos	contemporanei
ken	ken
campeona	campionessa
lgbt	lgbt
automáticamente	automaticamente
centre	centre
pacheco	pacheco
necesarias	necessarie
abraham	abramo
colaboradores	collaboratori
lost	lost
baterista	batterista
caras	facce
supercopa	supercoppa
turín	torino
lesiones	lesioni
disminución	diminuzione
aceptación	accettazione
sídney	sydney
facilidad	facilità
libras	libbre
