del	des
per	für
nel	im
con	mit
non	nicht
come	wie
sono	sind
dal	vom
più	mehr
anche	auch
seed	seed
all	all
the	the
due	zwei
tra	zwischen
era	war
dopo	nach
prima	erste
prima	zuerst
prima	vor
altri	andere
bar	bar
cest	mesz
anni	jahre
italiano	italienisch
essere	sein
questo	dieses
questo	diese
collegamenti	verbindungen
nell	nell
serie	serie
cet	cet
film	film
regia	regie
città	stadt
solo	nur
primo	ersten
san	san
poi	dann
msg	msg
voce	stimme
progetti	projekte
dove	wo
quando	wenn
anno	jahr
mentre	während
voci	stimmen
italia	italien
fino	bis
quale	welches
quale	welche
tre	drei
molto	sehr
from	from
può	kann
stesso	selbst
tutti	alle
stagione	jahreszeit
gruppo	gruppe
contro	gegen
calciatore	fußballspieler
roma	rom
così	so
abitanti	einwohner
till	till
chiesa	kirche
grande	groß
quindi	also
secolo	jahrhundert
guerra	krieg
sempre	immer
fatto	getan
volta	mal
storia	geschichte
fine	ende
aveva	hatte
album	album
già	bereits
alcuni	einige
ancora	noch
senza	ohne
francese	französisch
seconda	zweite
finale	finale
vita	leben
titolo	titel
shift	shift
campionato	meisterschaft
ogni	jeder
mondo	welt
tutto	alles
settembre	september
nazionale	nationalen
italiana	italienische
altro	sonstiges
sotto	unter
wikipedia	wikipedia
calcio	fußball
famiglia	familie
inoltre	außerdem
quali	welche
numero	zahl
milano	mailand
proprio	genau
ottobre	oktober
maggio	mai
ruolo	rolle
gennaio	januar
nuovo	neu
perché	warum
generale	allgemeinen
marzo	märz
squadra	team
dicembre	dezember
sue	sue
giugno	juni
questi	diese
agosto	august
luglio	juli
fra	fra
fra	zwischen
verso	zu
aprile	april
pagina	seite
periodo	zeitraum
novembre	november
giovanni	johannes
grazie	danke
insieme	zusammen
lui	er
invece	statt
invece	stattdessen
morte	tod
maria	maria
febbraio	februar
john	john
new	new
inglese	englisch
quattro	vier
attività	tätigkeit
causa	ursache
edizione	ausgabe
infatti	nämlich
qui	hier
nord	norden
diretto	direkten
esempio	beispiel
ultimo	letzter
sfondo	hintergrund
versione	version
provincia	provinz
attore	schauspieler
coppa	pokal
forma	form
codice	code
oggi	heute
poco	wenig
punto	punkt
tuttavia	jedoch
figlio	sohn
corso	laufe
allenatore	trainer
molti	viele
sistema	system
società	unternehmen
club	club
regione	region
sud	süden
discussione	diskussion
padre	vater
linea	linie
santa	santa
pubblicato	veröffentlicht
carlo	carlo
progetto	projekt
primi	ersten
mai	nie
sito	website
lungo	lange
uso	verwendung
uso	gebrauch
value	value
tedesco	deutsch
lavoro	arbeit
isbn	isbn
fare	tun
giorno	tag
termine	frist
ben	ben
specie	arten
specie	tierart
persone	menschen
pagine	seiten
volte	mal
set	set
inizio	anfang
jpg	jpg
sarebbe	wäre
rispetto	respekt
francesco	francesco
posizione	position
militare	militärischen
uomo	mann
meno	weniger
giorni	tage
carriera	karriere
mar	mar
scritto	geschrieben
ora	jetzt
territorio	territorium
gen	gen
antonio	antonio
giuseppe	giuseppe
quasi	fast
data	datum
terra	erde
presente	gegenwart
allora	dann
successo	erfolg
opere	werke
ordine	ordnung
categoria	kategorie
produzione	produktion
strada	straße
corpo	körper
quest	quest
scrittore	schriftsteller
lug	lug
file	datei
cura	pflege
francia	frankreich
lingua	sprache
battaglia	schlacht
attrice	schauspielerin
ott	ott
disciplina	disziplin
mag	mag
studio	studie
oro	gold
singolo	einzelnen
paese	land
arte	kunst
età	alter
storico	historischen
vescovo	bischof
york	york
squadre	mannschaften
precedente	früheren
episodi	episoden
chi	wer
paolo	paolo
attraverso	durch
possibile	möglich
avere	haben
servizio	service
regista	regisseur
punti	punkte
repubblica	republik
originale	original
apr	apr
palazzo	palast
giocatore	spieler
università	universität
isola	insel
capo	boss
divisione	abteilung
luogo	ort
ago	nadel
dic	dez
iii	iii
egli	er
napoli	neapel
parigi	paris
nonostante	trotz
gioco	spiel
terzo	dritter
ufficiale	offizielle
luigi	luigi
vittoria	sieg
centrale	zentrale
internazionale	internationalen
porta	tür
presenti	anwesend
popolazione	bevölkerung
america	amerika
piano	plan
prodotto	produkt
presenza	anwesenheit
libro	buch
scuola	schule
immagine	bild
esercito	armee
deve	muss
autore	autor
autore	verfasser
classifica	ranking
importante	wichtig
torneo	turnier
firenze	florenz
comunità	gemeinschaft
giovane	jung
madre	mutter
stazione	bahnhof
vari	verschiedene
pietro	pietro
studi	studien
fonte	quelle
acqua	wasser
torino	turin
cinque	fünf
partito	partei
unità	einheit
fonti	quellen
marcatori	marker
politica	politik
metà	hälfte
metri	meter
alto	hohen
alto	hoch
top	top
testo	text
usa	usa
tour	tour
teatro	theater
procedura	verfahren
cardinale	kardinal
unico	einzigartig
papa	papst
uomini	männer
visto	gesehen
ricerca	suche
principali	wichtigsten
massimo	höchstens
stile	stil
left	left
germania	deutschland
donna	frau
superficie	oberfläche
castello	schloss
distretto	bezirk
nota	anmerkung
mesi	monate
moglie	ehefrau
successivo	nächster
ritorno	rückkehr
costruzione	bau
subito	sofort
totale	gesamt
totale	insgesamt
canzone	lied
vista	vista
detto	gesagt
avuto	hatte
note	notizen
varie	verschiedenes
altezza	höhe
chitarra	gitarre
robert	robert
est	osten
fiume	fluss
figlia	tochter
realtà	realität
fuori	außerhalb
paul	paul
for	for
monte	monte
contea	grafschaft
museo	museum
forse	vielleicht
protagonista	hauptrolle
legge	gesetz
mario	mario
stadio	stadion
fase	phase
classe	klasse
amore	liebe
michael	michael
fratello	bruder
color	color
sviluppo	entwicklung
prime	prime
pittore	maler
sarà	wird
comuni	gemeinden
pubblico	öffentlichen
venezia	venedig
infine	schließlich
media	medien
struttura	struktur
gray	gray
paesi	ländern
personaggi	figuren
londra	london
sopra	oben
formazione	ausbildung
marco	marco
world	world
you	you
probabilmente	wahrscheinlich
sant	sant
bene	gut
almeno	zumindest
britannico	britischen
romano	romano
informazioni	informationen
italiani	italiener
locale	lokalen
james	james
giochi	spiele
disco	festplatte
conte	graf
giapponese	japanisch
direttore	direktor
peso	gewicht
meglio	besser
avevano	hatten
piccolo	klein
campionati	meisterschaften
cestista	basketballspieler
terza	dritte
programma	programm
nominato	ernannt
testa	kopf
romanzo	roman
potrebbe	könnte
jean	jean
forte	stark
forze	kräfte
william	william
diritto	recht
start	start
mare	meer
unione	union
star	star
piazza	piazza
george	george
potere	macht
rgb	rgb
presenze	anwesenheit
senso	sinn
rete	netzwerk
forza	kraft
breve	kurze
spagnolo	spanisch
van	van
ovest	westen
andrea	andrea
nato	geboren
controllo	kontrolle
winner	winner
saint	saint
don	don
passato	vergangenheit
caratteristiche	merkmale
edizioni	ausgaben
dire	sagen
guida	leitfaden
diocesi	diözese
consiglio	rat
villa	villa
mappa	karte
membri	mitglieder
giorgio	giorgio
problemi	probleme
problema	problem
milioni	millionen
mano	hand
migliore	beste
parti	teile
giornalista	journalist
mio	mein
festival	festival
civile	zivilen
valle	tal
luce	licht
league	league
lista	liste
compositore	komponist
sezione	abschnitt
attualmente	derzeit
ore	stunden
dio	gott
casi	fällen
inizia	beginnt
sinistra	links
modello	modell
istituto	institut
velocità	geschwindigkeit
imperatore	kaiser
movimento	bewegung
motore	motor
style	style
valore	wert
gruppi	gruppen
bologna	bologna
love	love
cultura	kultur
spazio	raum
troppo	zu
alessandro	alessandro
amico	freund
membro	mitglied
rock	rock
football	football
doppio	doppelte
formato	format
vinto	gewonnen
lunghezza	länge
essendo	dasein
processo	prozess
attacco	angriff
proprietà	eigentum
spagna	spanien
http	http
colore	farbe
vicino	nahe
orientale	östlichen
località	ort
man	man
principe	prinz
notte	nacht
dice	sagt
mese	monat
cancellazione	löschung
batteria	batterie
immagini	bilder
argento	silber
poeta	dichter
persona	person
charles	charles
rosso	rot
russo	russisch
comando	befehl
bianco	weiß
licenza	lizenz
reti	netze
funzione	funktion
scena	szene
richard	richard
cinema	kino
mia	mia
riferimento	bezug
simile	ähnlich
ragazza	mädchen
thomas	thomas
utenti	benutzer
elementi	elemente
franco	franco
costa	costa
entrambi	beide
arcivescovo	erzbischof
torre	turm
reale	realen
oppure	oder
vol	vol
produttore	hersteller
azione	aktion
risultati	ergebnisse
interesse	interesse
aggiornato	aktualisiert
campione	stichprobe
live	live
piuttosto	eher
donne	frauen
decide	entscheidet
parla	spricht
truppe	truppen
possibilità	möglichkeit
nero	schwarz
roberto	roberto
destra	rechts
difesa	verteidigung
accordo	abkommen
personale	personal
dimensioni	größe
radio	radio
records	records
sette	sieben
capitale	hauptstadt
martin	martin
situazione	situation
parole	worte
aiuto	hilfe
genova	genua
effetti	auswirkungen
greco	griechisch
scopo	zweck
prese	steckdosen
idea	idee
madonna	madonna
rivista	magazin
parco	park
resto	rest
otto	otto
direzione	richtung
marina	marina
richiesta	anfrage
alberto	alberto
editore	herausgeber
risultato	ergebnis
usato	gebraucht
mostra	ausstellung
inghilterra	england
duca	herzog
votazione	abstimmung
sociale	sozialen
cose	dinge
prova	prüfung
qualità	qualität
wiki	wiki
black	black
minuti	minuten
stella	stern
porto	hafen
angelo	engel
nulla	nichts
tecnica	technik
lega	liga
speciale	besondere
azienda	unternehmen
artista	künstler
pure	pure
anna	anna
record	rekord
diventa	wird
mercato	markt
versioni	versionen
chiamata	anruf
stagioni	jahreszeiten
sale	salz
libri	bücher
border	border
trovare	finden
cortometraggio	kurzfilm
stefano	stefano
natura	natur
tennis	tennis
capacità	fähigkeit
capacità	kapazität
dare	geben
buona	gute
frazione	bruchteil
nave	schiff
estate	sommer
giappone	japan
volume	lautstärke
fuoco	feuer
differenza	unterschied
campagna	kampagne
accesso	zugang
organizzazione	organisation
link	link
lago	see
canale	kanal
popolare	beliebt
deceduto	verstorben
ufficiali	amtlichen
viaggio	reise
quarto	vierten
tappa	etappe
ponte	brücke
materiale	material
pallacanestro	basketball
comprende	umfasst
bruno	bruno
fisica	physik
pilota	pilot
contiene	enthält
armi	waffen
relazione	bericht
oggetto	gegenstand
eventi	veranstaltungen
medico	arzt
semplice	einfach
ministro	minister
motivo	grund
sole	sonne
prodotti	produkte
prodotti	erzeugnisse
sport	sport
direttamente	direkt
grafica	grafiken
creare	erstellen
divisioni	abteilungen
isole	inseln
colonna	spalte
testi	texte
creato	erstellt
vecchio	alt
matrimonio	hochzeit
aggiornamento	update
onda	welle
aspetto	aussehen
architetto	architekt
contratto	vertrag
filippo	filippo
battuto	geschlagen
comunale	kommunalen
nascita	geburt
mark	mark
naturale	natürliche
coppia	paar
presto	bald
scelta	wahl
federico	federico
promozione	förderung
les	les
articolo	artikel
condizioni	bedingungen
linee	linien
locali	lokalen
futuro	zukunft
orchestra	orchester
right	right
settore	bereich
principalmente	meistens
principalmente	hauptsächlich
sebbene	obwohl
comandante	commander
settimana	woche
potenza	leistung
giocato	spielte
giocato	gespielt
esiste	existiert
com	com
russia	russland
cappella	kapelle
fin	fin
rai	rai
croce	kreuz
zone	gebiete
prende	nimmt
company	company
michele	michele
conosciuto	bekannt
regina	königin
tradizione	tradition
polizia	polizei
migliori	besten
sconfitta	niederlage
music	music
pace	frieden
demografica	demografischen
palermo	palermo
qualcosa	etwas
massa	masse
energia	energie
rosa	rosa
aria	luft
fondata	gegründet
tracce	spuren
nessuno	niemand
marito	ehemann
capitano	captain
didascalia	bildunterschrift
elezioni	wahlen
teoria	theorie
distribuzione	verteilung
dieci	zehn
evento	veranstaltung
raggiungere	erreichen
tom	tom
enciclopedia	enzyklopädie
joseph	joseph
canzoni	lieder
popolo	volk
uscita	ausfahrt
uscita	ausgang
distanza	entfernung
portato	gebracht
pro	pro
max	max
qualsiasi	beliebig
africa	afrika
lingue	sprachen
memoria	speicher
amici	freunde
maestro	meister
bambino	kind
unito	vereinigten
libero	frei
giacomo	giacomo
fratelli	brüder
vera	vera
standard	standard
jack	jack
qualcuno	jemand
svg	svg
smith	smith
scoperto	entdeckt
fondazione	stiftung
nomi	namen
distribuito	verteilt
particolarmente	besonders
festa	party
cattolica	katholischen
cuore	herz
villaggio	dorf
buon	gutes
partecipanti	teilnehmer
morto	tot
dietro	hinter
apertura	öffnung
louis	louis
vittorie	siege
chiese	kirchen
galleria	galerie
esperienza	erfahrung
parola	wort
verde	grün
vince	gewinnt
sceneggiatore	drehbuchautor
preso	genommen
bambini	kinder
santi	heiligen
fatti	fakten
luca	luca
accademia	akademie
passa	vergeht
servizi	dienstleistungen
navi	schiffe
dedicato	gewidmet
with	with
partecipato	teilgenommen
formula	formel
arrivo	anreise
titolare	inhaber
latino	latein
sicilia	sizilien
elaborazione	ausarbeitung
international	international
open	open
lorenzo	lorenzo
letteratura	literatur
libertà	freiheit
bronzo	bronze
tecniche	techniken
ambiente	umwelt
missione	mission
regionale	regionale
arriva	kommt
evitare	vermeiden
frank	frank
dovrebbe	sollte
henry	henry
costruito	erbaut
intervento	intervention
pietra	stein
bandiera	flagge
critica	kritik
tecnico	technischen
vittorio	vittorio
foto	fotos
incontri	treffen
arbitro	schiedsrichter
quartiere	viertel
cinese	chinesisch
svizzera	schweiz
luoghi	orte
tardi	spät
blu	blau
trattato	vertrag
american	american
diritti	rechte
eletto	gewählt
soldati	soldaten
king	king
federazione	föderation
ragazzo	junge
male	schlecht
confronti	vergleiche
carattere	charakter
bottom	bottom
monaco	münchen
angeles	angeles
soggetto	subjekt
operazione	operation
ucciso	getötet
sorella	schwester
vincitore	gewinner
lee	lee
raccoglie	sammelt
sicurezza	sicherheit
passo	schritt
xvi	xvi
biblioteca	bibliothek
brasile	brasilien
sistemi	systeme
volo	flug
significa	bedeutet
architettura	architektur
settentrionale	nördlichen
simili	ähnliche
necessario	notwendig
difficoltà	schwierigkeiten
under	under
punteggio	punktzahl
tema	thema
animali	tiere
ingresso	eintritt
val	val
vertical	vertical
olandese	niederländisch
caccia	jagd
creazione	schaffung
nasce	entsteht
poteva	konnte
noi	wir
cesare	caesar
colori	farben
diff	diff
cattedrale	kathedrale
stampa	presse
mosca	moskau
diventare	werden
lettera	brief
austria	österreich
pos	pos
esemplari	exemplare
daniel	daniel
insee	insee
voti	stimmen
motivi	gründe
televisivo	glotze
giulio	giulio
pubblicazione	veröffentlichung
berlino	berlin
onore	ehre
super	super
conoscenza	wissen
aperto	geöffnet
blocco	block
maglia	trikot
corsa	rennen
pratica	praxis
commissione	kommission
attenzione	achtung
play	play
arco	bogen
autorità	behörden
campi	felder
oggetti	objekte
domenico	domenico
autori	autoren
abbastanza	genug
bob	bob
tedeschi	deutsche
lettere	briefe
effetto	wirkung
resistenza	widerstand
tentativo	versuch
josé	josé
xix	xix
west	west
orientation	orientation
canvas	canvas
scala	skalieren
censimento	volkszählung
chris	chris
contrario	gegenteil
partecipazione	beteiligung
mike	mike
vincenzo	vincenzo
modifiche	änderungen
omonimo	gleichnamigen
canadese	kanadischen
famiglie	familien
svedese	schwedisch
australia	australien
match	match
best	best
secoli	jahrhunderte
grand	grand
press	press
ottiene	bekommt
esterno	externen
sangue	blut
sergio	sergio
traduzione	übersetzung
piani	pläne
padova	padua
pierre	pierre
chiaro	klar
trovato	gefunden
cina	china
justify	justify
alpi	alpen
supporto	unterstützung
nicola	nicola
difficile	schwierig
ragazzi	jungs
india	indien
misura	maßnahme
pianta	pflanze
termini	fristen
occhi	augen
bianca	bianca
regioni	regionen
california	kalifornien
premi	prämien
risposta	antwort
inserito	eingefügt
commenta	kommentiert
entrambe	beide
realizzazione	realisierung
secondi	sekunden
modelli	modelle
sesso	geschlecht
portò	brachte
ragione	grund
strumenti	instrumente
steve	steve
contenuto	inhalt
famoso	berühmt
juan	juan
terreno	boden
cielo	himmel
notevole	bemerkenswert
xiii	xiii
durata	dauer
componenti	komponenten
analisi	analyse
maggioranza	mehrheit
usare	verwenden
tempio	tempel
gesù	jesus
quantità	quantität
quantità	menge
joe	joe
concerto	konzert
pertanto	deshalb
pertanto	daher
mani	hände
jones	jones
vive	lebt
austriaco	österreicher
williams	williams
filosofia	philosophie
natale	weihnachten
discussioni	diskussionen
aggiunta	zusatz
disponibile	verfügbar
vienna	wien
guardia	wache
attivo	aktiv
conflitto	konflikt
partecipa	beteiligt
confine	grenze
stelle	sterne
crisi	krise
avvocato	rechtsanwalt
quarta	vierte
claudio	claudio
bassi	niederlanden
facciata	fassade
entra	tritt
descrizione	beschreibung
raggiunto	erreicht
fondato	gegründet
avanti	weiter
conquista	eroberung
esistenza	existenz
francisco	francisco
canada	kanada
aereo	flugzeug
anime	seelen
anime	anime
economia	wirtschaft
regole	regeln
trasmissione	übermittlung
air	air
criteri	kriterien
sarebbero	würden
sarebbero	wären
pianeta	planet
romani	römer
edifici	gebäude
pianoforte	klavier
entro	innerhalb
sapere	wissen
time	time
nessuna	keine
scott	scott
guglielmo	wilhelm
legno	holz
altare	altar
amministrazione	verwaltung
storie	geschichten
ospedale	krankenhaus
bordo	rand
funzioni	funktionen
metodo	methode
strutture	strukturen
portare	bringen
battista	battista
operazioni	operationen
trono	thron
nazioni	nationen
simon	simon
red	red
religione	religion
vecchia	alte
commerciale	kommerzielle
arma	waffe
house	house
ufficialmente	offiziell
trasporto	transport
scene	szenen
teste	köpfe
utile	nützlich
life	life
royal	royal
vii	vii
mary	mary
signore	sir
imperiale	kaiserlichen
cristo	christus
monastero	kloster
contatto	kontakt
diffusione	verbreitung
lascia	lass
white	white
big	big
tipi	typen
territori	territorien
lavorare	arbeiten
amministratore	administrator
orbita	umlaufbahn
walter	walter
madrid	madrid
letto	bett
leone	löwe
ala	flügel
genitori	eltern
xii	xii
simbolo	symbol
quinto	fünfter
xviii	xviii
ingegnere	ingenieur
bgcolor	bgcolor
luna	mond
argentina	argentinien
stemma	wappen
spirito	geist
soluzione	lösung
statistiche	statistiken
iniziata	begonnen
ministero	ministerium
niente	nichts
computer	computer
settimane	wochen
protezione	schutz
bari	bari
ufficio	büro
filosofo	philosoph
sur	sur
harry	harry
danni	schäden
chitarrista	gitarrist
xvii	xvii
numeri	zahlen
ferro	eisen
messico	mexiko
normale	normal
traccia	spur
washington	washington
rio	rio
messaggio	nachricht
entrare	rein
borgo	borgo
out	out
categorie	kategorien
parma	parma
united	united
iniziato	begonnen
geografia	geographie
latitudine	breitengrad
ovviamente	natürlich
sonora	sonora
strumento	instrument
brasiliano	brasilianischen
colpo	schlag
brian	brian
definitivamente	endgültig
leggere	lesen
ipotesi	hypothese
influenza	einfluss
modalità	modus
night	night
organo	orgel
organo	organ
capire	verstehen
giallo	gelb
grecia	griechenland
mura	mauern
scienze	wissenschaften
that	that
etichetta	etikett
#aaa	#aaa
coda	schwanz
chiede	bittet
incidente	unfall
xiv	xiv
sostituito	ersetzt
jim	jim
metal	metal
verona	verona
basilica	basilika
composizione	zusammensetzung
guido	guido
significato	bedeutung
responsabile	verantwortlich
championship	championship
valign	valign
fede	glaube
prove	beweise
nemico	feind
documenti	dokumente
poteri	befugnisse
young	young
segretario	sekretär
istituzione	institution
decreto	dekret
strade	straßen
concetto	konzept
edit	edit
sesto	sexten
gradi	grad
rivoluzione	revolution
bill	bill
motori	motoren
campioni	proben
abitato	bewohnt
piante	pflanzen
temperatura	temperatur
imprenditore	unternehmer
perso	verloren
brescia	brescia
asteroide	asteroid
benedetto	gesegnet
carlos	carlos
scoperta	entdeckung
guerre	kriege
carta	charta
fuga	flucht
tony	tony
post	post
ungherese	ungarisch
macchina	auto
cavallo	pferd
decisione	entscheidung
obiettivo	ziel
particolari	details
euro	euro
chicago	chicago
oscar	oscar
tradizionale	traditionellen
enciclopedica	enzyklopädische
ciclo	zyklus
vice	stellvertretender
viii	viii
internet	internet
presentato	präsentiert
sovietica	sowjetischen
edward	edward
scuole	schulen
reggimento	regiment
difensore	verteidiger
sconfitto	besiegt
olio	öl
possiede	besitzt
fisico	physischen
talk	talk
pezzi	stücke
critico	kritisch
immediatamente	sofort
registrato	registriert
commedia	komödie
introduzione	einleitung
principio	grundsatz
principio	prinzip
amm	amm
punta	spitze
deciso	beschlossen
test	test
caps	caps
egitto	ägypten
valori	werte
portiere	portier
uefa	uefa
dominio	domain
mantenere	halten
brown	brown
conti	konten
parlare	sprechen
elemento	element
zero	null
giocare	spielen
compare	erscheint
resta	bleibt
day	day
hall	hall
scultore	bildhauer
jan	jan
videogioco	videospiel
nipote	nichte
magari	vielleicht
title	title
php	php
polacco	polnisch
riforma	reform
statua	statue
software	software
necessità	notwendigkeit
attacchi	angriffe
principessa	prinzessin
debutto	debüt
montagna	berg
malattia	krankheit
livelli	ebenen
professore	professor
felice	glücklich
verità	wahrheit
denominazione	bezeichnung
flotta	flotte
sin	sin
salvatore	salvatore
comportamento	verhalten
corona	krone
costituzione	verfassung
combattimento	kampf
copyright	copyright
parlamento	parlament
caduta	fall
visione	vision
sviluppato	entwickelt
rivolta	revolte
talvolta	manchmal
capitolo	kapitel
sovrano	souverän
consenso	konsens
pisa	pisa
compito	aufgabe
notizie	nachrichten
pio	pio
concorso	gewinnspiel
france	france
sam	sam
rischio	risiko
monti	monti
nazione	nation
primavera	frühling
agente	agent
nazionalità	nationalität
college	college
umano	menschlichen
sardegna	sardinien
indipendenza	unabhängigkeit
materiali	materialien
eccentricità	exzentrizität
banda	bande
commercio	handel
png	png
bianchi	weißen
nove	neun
diego	diego
ali	ali
can	can
riserva	reserve
televisione	fernsehen
sceneggiatura	drehbuch
laura	laura
basato	basiert
riccardo	richard
fiori	blumen
vergine	jungfrau
spettacolo	show
byte	bytes
posizioni	positionen
polonia	polen
toscana	toskana
entrata	eingang
fanteria	infanterie
piero	piero
admin	admin
costruire	bauen
alex	alex
modifica	bearbeiten
marino	marino
coro	chor
frase	satz
industria	industrie
solitamente	normalerweise
uccidere	töten
asia	asien
lord	lord
atp	atp
comunicazione	kommunikation
rugby	rugby
scrittrice	schriftstellerin
norvegese	norwegisch
johnson	johnson
vescovi	bischöfe
potente	mächtig
esclusivamente	ausschließlich
tribù	stamm
personalità	persönlichkeit
finalista	finalist
interpretazione	auslegung
christian	christian
definizione	definition
partecipare	teilnehmen
portale	portal
province	provinzen
centri	zentren
assegnato	zugewiesen
nemici	feinde
errore	fehler
mondadori	mondadori
semi	samen
settanta	siebzig
leonardo	leonardo
originariamente	ursprünglich
universo	universum
domenica	sonntag
arthur	arthur
limite	begrenzen
first	first
ottanta	achtzig
assenza	abwesenheit
filmografia	filmografie
porte	türen
indipendente	unabhängigen
abilità	geschicklichkeit
governatore	gouverneur
giusto	richtig
blue	blue
patria	vaterland
fenomeno	phänomen
roger	roger
alleanza	allianz
copie	kopien
gianni	gianni
condizione	bedingung
regime	regelung
prevalentemente	überwiegend
lancio	start
industriale	industrielle
aspetti	aspekte
citato	zitiert
tenere	halten
centrocampista	mittelfeldspieler
espressione	ausdruck
iso	iso
neat	neat
diventato	geworden
appartiene	gehört
pieno	voll
giustizia	gerechtigkeit
collezione	sammlung
ritiro	rücknahme
firma	unterschrift
adesso	jetzt
siti	websites
poesia	poesie
occhio	auge
cavaliere	ritter
segreto	geheimnis
racconta	erzählt
santuario	heiligtum
little	little
miss	miss
taylor	taylor
gas	gas
lady	lady
relativa	relative
latina	latina
manga	manga
prestito	darlehen
baviera	bayern
ciclista	radfahrer
aerei	flugzeuge
fondatore	gründer
sindaco	bürgermeister
visita	besuch
dinastia	dynastie
identità	identität
dimensione	dimension
martino	martino
finalmente	endlich
sacro	heilig
emilia	emilia
mezzi	mittel
salute	gesundheit
chiara	klare
cori	chöre
veneto	venetien
maurizio	mauritius
war	war
proprietario	eigentümer
principi	grundsätze
principi	prinzipien
animale	tier
accanto	neben
marie	marie
programmi	programme
informazione	information
siena	siena
davis	davis
real	real
chiusura	schließung
economico	wirtschaftlichen
archivio	archiv
contesto	kontext
matteo	matteo
catena	kette
jackson	jackson
albert	albert
https	https
definito	definiert
elena	elena
rimasto	geblieben
vale	vale
ray	ray
domanda	frage
danno	schaden
svezia	schweden
studenti	studenten
habitat	lebensräume
habitat	lebensraum
classico	klassiker
faccia	gesicht
pop	pop
catania	catania
permesso	erlaubnis
challenger	challenger
viola	lila
varietà	vielzahl
km²	km²
circuito	schaltung
scrive	schreibt
discorso	rede
targa	kennzeichen
attaccante	stürmer
reazione	reaktion
spedizione	versand
medicina	medizin
gente	leute
eric	eric
abbazia	abtei
muto	stumm
piloti	piloten
eccezione	ausnahme
sessanta	sechzig
vincere	gewinnen
compreso	einschließlich
posteriore	hinten
riceve	erhält
ferrari	ferrari
calabria	kalabrien
dizionario	wörterbuch
modella	model
registrazione	registrierung
religiosa	religiös
girl	girl
medievale	mittelalterlichen
incontra	trifft
ungheria	ungarn
possesso	besitz
monumenti	sehenswürdigkeiten
portoghese	portugiesisch
sezioni	abschnitte
fuso	geschmolzen
colonne	spalten
barbara	barbara
giardino	garten
foglie	blätter
street	street
kevin	kevin
green	green
savoia	savoyen
compagni	genossen
idee	ideen
assedio	belagerung
potuto	konnte
matematico	mathematiker
confini	grenzen
www	www
spada	schwert
regolare	regelmäßige
civili	zivilisten
ospita	beherbergt
online	online
aumento	erhöhung
lavora	arbeitet
seguire	folgen
affari	angelegenheiten
irlandese	irisch
vetrina	schaufenster
albero	baum
relazioni	beziehungen
augusto	augusto
esecuzione	ausführung
imho	imho
arrivò	kam
successi	erfolge
reggio	reggio
giri	runden
hill	hill
esempi	beispiele
documento	dokument
nucleo	kern
insegnante	lehrer
hans	hans
ebrei	juden
congresso	kongress
patrick	patrick
artiglieria	artillerie
jazz	jazz
davvero	wirklich
banca	bank
concerti	konzerte
trieste	triest
arcidiocesi	erzbistum
karl	karl
minimo	minimum
ordini	bestellungen
giudizio	urteil
tesi	these
anteriore	vorderen
mediterraneo	mittelmeer
jacques	jacques
moto	motorrad
vittime	opfer
colonia	köln
tuo	dein
somma	summe
crescita	wachstum
giudice	richter
andrew	andrew
messina	messina
cambiare	ändern
portogallo	portugal
renato	renato
americani	amerikaner
tokyo	tokio
alleati	verbündeten
lontano	weit
variante	variante
françois	françois
leggenda	legende
costante	konstante
luis	luis
precedentemente	früher
generazione	generation
piattaforma	plattform
belgio	belgien
modena	modena
biografia	biographie
digitale	digitalen
omicidio	mord
umberto	umberto
caterina	katharina
abate	abt
mauro	mauro
tommaso	tommaso
conosce	kennt
cantautore	songwriter
quinta	fünfte
aldo	aldo
high	high
comunista	kommunistischen
kim	kim
alfonso	alfonso
dentro	innen
vantaggio	vorteil
riconoscimento	anerkennung
game	game
mandato	mandat
interpreti	dolmetscher
zio	onkel
pensare	denken
rose	rose
muore	stirbt
colonnello	oberst
visibile	sichtbar
ritratto	porträt
scienza	wissenschaft
affreschi	fresken
luciano	luciano
vendita	verkauf
perdita	verlust
this	this
brigata	brigade
combattere	kämpfen
novanta	neunzig
carl	carl
tecnologia	technologie
scrittura	schreiben
irlanda	irland
virginia	virginia
suono	ton
attiva	aktiv
matematica	mathematik
condotto	geführt
tipico	typisch
ceco	tschechisch
passione	leidenschaft
ruoli	rollen
andré	andré
flag	flag
moderno	modern
interni	internen
concessione	gewährung
anderson	anderson
amministrativo	administrativen
tim	tim
trattamento	behandlung
contributo	beitrag
assoluto	absolute
cimitero	friedhof
salvo	außer
trofeo	trophäe
espansione	expansion
estero	ausland
amicizia	freundschaft
senato	senat
verdi	grünen
temi	themen
invasione	invasion
altrimenti	sonst
lewis	lewis
neri	schwarze
mille	tausend
inverno	winter
componente	komponente
avviso	bekanntmachung
ottocento	ottocento
diffuso	verbreitet
atene	athen
alan	alan
tela	leinwand
emanuele	emanuele
sposa	braut
collegio	kollegium
marchese	marquis
praticamente	praktisch
victor	victor
champions	champions
previsto	vorgesehen
pokémon	pokémon
girato	gedreht
nick	nick
ivan	ivan
billy	billy
pezzo	stück
sovietico	sowjetischen
novecento	novecento
napoleone	napoleon
specialmente	besonders
promosso	gefördert
corsi	kurse
cronologia	verlauf
lazio	lazio
anima	seele
wilson	wilson
sufficiente	ausreichend
stretto	engen
dialetto	dialekt
lavorato	arbeitete
dodici	zwölf
texas	texas
fabio	fabio
medioevo	mittelalter
eventuali	etwaige
emilio	emilio
regola	regel
clima	klima
pil	bip
prix	prix
cittadino	bürger
pittura	malerei
simone	simone
conta	zählt
google	google
men	men
atletica	leichtathletik
scientifico	wissenschaftlichen
tenente	lieutenant
vento	wind
howard	howard
gaetano	gaetano
cristiano	christlich
braccio	arm
angolo	winkel
solare	solar
danese	dänisch
eclittica	ekliptik
riferisce	bezieht
movimenti	bewegungen
chiama	nennt
spalle	schultern
back	back
adam	adam
sfida	herausforderung
will	will
semifinale	halbfinale
avversario	gegner
documentario	dokumentarfilm
equipaggio	besatzung
facile	einfach
stazioni	stationen
estende	erstreckt
impianti	anlagen
lombardia	lombardei
windows	windows
relativamente	relativ
leggermente	leicht
jimmy	jimmy
trenta	dreißig
segnali	signale
society	society
ciao	hallo
esposizione	ausstellung
esposizione	exposition
ford	ford
alessandria	alexandria
assemblea	versammlung
foresta	wald
dante	dante
musicisti	musiker
circondario	landkreis
miniserie	miniserie
ispirato	inspiriert
penisola	halbinsel
force	force
cinquanta	fünfzig
agostino	agostino
doppiatore	synchronsprecher
slalom	slalom
paura	angst
motivazione	motivation
candidato	kandidaten
cannoni	kanonen
letterario	literarische
infanzia	kindheit
inviato	geschickt
capace	fähig
lettura	lesung
occupazione	beschäftigung
anne	anne
fasi	phasen
sci	ski
fernando	fernando
capelli	haare
restauro	restaurierung
daniele	daniele
colle	colle
tastiere	tastaturen
estratto	extrakt
costo	kosten
aquila	adler
romanzi	romane
fusione	fusion
saga	saga
francis	francis
assolutamente	absolut
fama	ruhm
autonomia	autonomie
vino	wein
assistente	assistent
remix	remix
vincitori	gewinner
copertina	cover
ricostruzione	wiederaufbau
vicenza	vicenza
operativo	operationellen
boy	boy
johann	johann
alice	alice
individuale	individuelle
perde	verliert
pericolo	gefahr
duomo	dom
suolo	boden
iniziativa	initiative
tabella	tabelle
johnny	johnny
applicazione	anwendung
sogno	traum
sposato	verheiratet
ferrara	ferrara
risorse	ressourcen
commissario	kommissar
occidentali	westlichen
ugo	ugo
enzo	enzo
jeff	jeff
asse	achse
denaro	geld
intervista	interview
north	north
successione	nachfolge
lucio	lucius
south	south
australiano	australier
chiuso	geschlossen
sacerdote	priester
tomba	grab
votazioni	abstimmungen
amica	freundin
stephen	stephen
potrebbero	könnten
dolce	süß
margherita	margherita
diametro	durchmesser
bergamo	bergamo
dan	dan
anthony	anthony
distruzione	zerstörung
mantova	mantua
tennista	tennisspieler
trasferimento	übertragung
perdere	verlieren
treni	züge
chimica	chemie
long	long
livorno	livorno
quotidiano	tageszeitung
quotidiano	zeitung
romania	rumänien
trama	handlung
ceca	egks
anello	ring
passeggeri	passagiere
bruce	bruce
golden	golden
piemonte	piemont
michel	michel
console	konsole
not	not
offre	bietet
pallavolo	volleyball
marcello	marcello
conoscere	kennen
residenza	wohnsitz
ducato	ducato
trasporti	verkehr
liberazione	befreiung
ricco	reich
profondità	tiefe
alba	sonnenaufgang
alfred	alfred
nobili	edlen
bacino	becken
rocca	rocca
aggiunto	hinzugefügt
rifugio	zuflucht
andy	andy
fortezza	festung
annunciato	angekündigt
personalmente	persönlich
pelle	haut
classificazione	einstufung
tranne	außer
cambridge	cambridge
profilo	profil
barone	baron
catalogo	katalog
migliorare	verbessern
giulia	giulia
indiano	indischen
pubblicazioni	veröffentlichungen
ammiraglio	admiral
cantone	kanton
istruzione	bildung
saggio	weise
ambienti	umgebungen
socialista	sozialistischen
cagliari	cagliari
manuel	manuel
produrre	produzieren
caratteri	zeichen
apparizione	auftritt
conservato	konserviert
bibliografia	bibliographie
interessante	interessant
design	design
doppia	doppelzimmer
are	are
purtroppo	leider
rimanere	bleiben
avventura	abenteuer
central	central
assunto	eingenommen
impegno	engagement
disegni	zeichnungen
british	british
perdite	verluste
las	las
cane	hund
blues	blues
death	death
selezione	auswahl
allen	allen
volto	gesicht
hollywood	hollywood
educazione	erziehung
fabbrica	fabrik
consente	ermöglicht
fuggire	fliehen
norma	norma
douglas	douglas
liceo	highschool
continuare	fortfahren
vito	vito
teresa	teresa
aeronautica	luftfahrt
what	what
east	east
processi	prozesse
muro	mauer
disney	disney
capito	verstanden
colpito	getroffen
consigliere	berater
miller	miller
down	down
scomparsa	vermisst
giuliano	giuliano
fred	fred
piede	fuß
impiegato	angestellter
riconosciuto	anerkannt
uguale	gleich
diplomatico	diplomatischen
ramo	zweig
nomina	ernennung
sicuro	sicher
fox	fox
gordon	gordon
veloce	schnell
manager	manager
wrestling	wrestling
danimarca	dänemark
scozia	schottland
bocca	mund
arena	arena
end	end
criminale	kriminellen
trasmesso	übermittelt
acido	säure
francesca	francesca
ludovico	ludovico
elisabetta	elisabeth
robin	robin
who	who
leo	leo
percussioni	percussion
charlie	charlie
fiducia	vertrauen
org	org
torri	türme
battaglione	bataillon
fiat	fiat
fabrizio	fabrizio
raggio	radius
frequenza	häufigkeit
atleti	athleten
tornei	turniere
desiderio	wunsch
matt	matt
ken	ken
lucia	lucia
infinito	unendlichkeit
trasferito	übertragen
richieste	anfragen
minaccia	bedrohung
jane	jane
marc	marc
girolamo	girolamo
oceano	ozean
pensa	denkt
sequenza	sequenz
pesi	gewichte
ritirato	zurückgezogen
alfredo	alfredo
voleva	wollte
missioni	dienstreisen
aprire	öffnen
dopoguerra	nachkriegszeit
riva	riva
tribunale	gericht
metodi	methoden
prezzo	preis
oxford	oxford
autunno	herbst
cavalleria	kavallerie
descritto	beschrieben
archi	bögen
definita	definiert
boston	boston
sanremo	sanremo
trento	trient
trad	trad
perugia	perugia
rocco	rocco
finlandese	finnischen
heart	heart
eva	eva
civiltà	zivilisation
panorama	panorama
pedro	pedro
vecchi	alten
dillo	sag
gabriele	gabriele
veramente	wirklich
trasformazione	verarbeitung
aumentare	erhöhen
wild	wild
prigionieri	gefangene
agricoltura	landwirtschaft
israele	israel
accusa	anklage
responsabilità	verantwortung
responsabilità	haftung
road	road
franz	franz
morire	sterben
gregorio	gregorio
dark	dark
fame	hunger
treno	zug
davide	david
videogiochi	videospiele
last	last
milan	milan
privato	privaten
morale	moral
henri	henri
aires	aires
eroe	held
alpino	alpinen
navata	kirchenschiff
adriano	adriano
incluso	inklusive
acquistato	gekauft
greci	griechen
professionista	profi
pasquale	pasquale
pontificio	päpstliches
buenos	buenos
espresso	ausgedrückt
introdotto	eingeführt
sassonia	sachsen
fiumi	flüsse
friedrich	friedrich
uccelli	vögel
elizabeth	elizabeth
cavalli	pferde
variabile	variable
mix	mix
pianista	pianist
annuale	jährlichen
cristiani	christen
migliaia	tausende
moore	moore
indoor	indoor
divinità	gottheit
acciaio	stahl
campagne	kampagnen
corrispondenza	korrespondenz
violino	violine
bonus	bonus
ferrovie	eisenbahn
campanile	campanile
settimo	siebten
differenze	unterschiede
razza	rasse
laboratorio	labor
destino	schicksal
abbandonato	verlassen
corrispondente	entsprechenden
baseball	baseball
sostituzione	ersatz
oliver	oliver
costi	kosten
occasioni	gelegenheiten
probabile	wahrscheinliche
probabile	wahrscheinlich
ryan	ryan
prefettura	präfektur
interessi	zinsen
hot	hot
opposizione	opposition
istituzioni	institutionen
poesie	gedichte
elettronica	elektronische
eliminazione	beseitigung
monete	münzen
pareti	wände
stone	stone
decisamente	definitiv
convinto	überzeugt
arabo	arabisch
dave	dave
torrente	torrent
sinistro	linken
menzionato	erwähnt
marmo	marmor
sky	sky
indiana	indiana
russell	russell
scontri	auseinandersetzungen
way	way
commento	kommentar
certamente	sicherlich
terrestre	terrestrischen
jonathan	jonathan
western	western
andato	gegangen
turchia	türkei
localizzazione	lokalisierung
sun	sun
vincitrice	gewinnerin
classi	klassen
alternativa	alternative
cognome	nachname
speranza	hoffnung
esattamente	genau
feat	feat
italo	italo
schermo	bildschirm
norvegia	norwegen
women	women
riduzione	verringerung
distretti	bezirke
manuale	handbuch
conferenza	konferenz
like	like
venduto	verkauft
dick	dick
varianti	varianten
pesce	fisch
macchine	maschinen
gerusalemme	jerusalem
alberi	bäume
two	two
batterista	schlagzeuger
decenni	jahrzehnte
punk	punk
salerno	salerno
riviste	zeitschriften
good	good
violenza	gewalt
jason	jason
ridotto	reduziert
confronto	vergleich
valutazione	bewertung
chiaramente	eindeutig
canali	kanäle
regio	regio
dance	dance
inutile	nutzlos
successore	nachfolger
claude	claude
fascista	faschistischen
conservazione	erhaltung
como	como
offerta	angebot
roy	roy
bartolomeo	bartolomeo
senatore	senator
arrestato	verhaftet
soldi	geld
eliminare	löschen
son	son
indietro	zurück
bernard	bernard
democratico	demokratischen
include	beinhaltet
misure	maßnahmen
stub	stub
risolvere	lösen
ombra	schatten
year	year
concilio	konzil
paola	paola
logo	logo
deputato	abgeordneten
virtù	tugend
agenzia	agentur
master	master
partiti	parteien
cerimonia	zeremonie
distrutto	zerstört
boss	boss
riconoscimenti	auszeichnungen
free	free
sostanza	substanz
ancona	ancona
ospite	gast
sofia	sofia
medaglie	medaillen
religiosi	religiöse
tag	tags
jordan	jordan
paragrafo	absatz
confederazione	eidgenossenschaft
special	special
musical	musical
navigazione	navigation
box	box
bernardo	bernardo
raffaele	raffaele
cambiato	verändert
venire	kommen
eugenio	eugenio
osservazione	beobachtung
classifiche	rankings
corea	korea
html	html
formazioni	formationen
copertura	deckung
costantinopoli	konstantinopel
larghezza	breite
vendetta	rache
garibaldi	garibaldi
gian	gian
clemente	clemente
martire	märtyrer
yard	yard
preparazione	vorbereitung
carolina	carolina
condannato	verurteilt
esperto	experte
cento	hundert
cucina	küche
einaudi	einaudi
poste	poste
sepolto	begraben
costellazione	sternbild
eccellenza	exzellenz
pieve	pieve
ideale	ideal
firmato	unterzeichnet
sconfitte	niederlagen
castel	castel
nicolas	nicolas
umanità	menschlichkeit
montana	montana
baby	baby
discesa	abstieg
cristina	cristina
terremoto	erdbeben
cemento	zement
space	space
legale	legal
tardo	späten
ucraina	ukraine
tasso	rate
esistente	bestehenden
esistente	bestehende
kelly	kelly
sabato	samstag
qualificazione	qualifikation
cause	ursachen
serata	abend
agenti	bediensteten
compresi	einschließlich
descrive	beschreibt
tastiera	tastatur
conduce	führt
veicoli	fahrzeuge
accetta	akzeptiert
clan	clan
gary	gary
programmazione	programmierung
vicini	nachbarn
fattori	faktoren
dead	dead
sessuale	sexuelle
praga	prag
turco	türkisch
steven	steven
statue	statuen
centinaia	hunderte
pavia	pavia
great	great
rappresentante	vertreter
tradotto	übersetzt
min	min
old	old
dolore	schmerz
studiare	studieren
impossibile	unmöglich
vissuto	gelebt
vissuto	lebte
wayne	wayne
accademico	akademischen
gino	gino
segnale	signal
chiesto	gefragt
tensione	spannung
toni	toni
hamilton	hamilton
progettato	entworfen
debutta	debüts
conferma	bestätigung
tradizioni	traditionen
danza	tanz
tentativi	versuche
turismo	tourismus
chiunque	jedermann
popoli	völker
inter	inter
sydney	sydney
segreti	geheimnisse
pietroburgo	petersburg
magia	magie
christopher	christopher
stranieri	ausländer
associazioni	verbände
patto	pakt
candidatura	bewerbung
sánchez	sánchez
river	river
permettere	ermöglichen
drago	drachen
prato	rasen
ligure	ligure
bryan	bryan
iscrizione	eintragung
dubbi	zweifel
prigione	gefängnis
liga	liga
conclusione	schlussfolgerung
puntate	einsätze
manca	fehlt
britannici	briten
utc	utc
giancarlo	giancarlo
collina	hügel
kong	kong
contrasto	kontrast
animazione	animation
recupero	verwertung
corporation	corporation
eliminato	gelöscht
conserva	behält
scambio	austausch
gatto	katze
elettrico	elektrische
requisiti	anforderungen
ross	ross
densità	dichte
maurice	maurice
decennio	jahrzehnt
decennio	dekade
esemplare	exemplar
araldica	heraldik
battaglie	schlachten
romeo	romeo
giurista	jurist
schema	schema
his	his
corrado	corrado
iata	iata
nba	nba
clark	clark
rapper	rapper
romagna	romagna
silvio	silvio
ernesto	ernesto
pacifico	pazifik
parzialmente	teilweise
adams	adams
gabriel	gabriel
amsterdam	amsterdam
treviso	treviso
esperienze	erfahrungen
fantasy	fantasy
polo	polo
indice	index
castelli	schlösser
tetto	dach
here	here
pier	pier
teologo	theologe
persino	sogar
florida	florida
utili	nützliche
playoff	playoffs
vuoto	leer
gilbert	gilbert
database	datenbank
stabile	stabil
detective	detective
detective	detektiv
friuli	friaul
bell	bell
final	final
vincent	vincent
miliardi	milliarden
ordinato	bestellt
giovanna	johanna
cile	chile
individui	einzelpersonen
killer	killer
eddie	eddie
ettore	ettore
ceduto	nachgegeben
emisfero	hemisphäre
wikimedia	wikimedia
lavoratori	arbeitnehmer
maschio	männlich
sostituire	ersetzen
nucleare	nukleare
giunto	gekommen
bellezza	schönheit
terme	terme
disegnato	gezeichnet
confermato	bestätigt
lupo	wolf
presidenza	präsidentschaft
silva	silva
letteralmente	buchstäblich
bolla	blase
drammaturgo	dramatiker
teorie	theorien
finlandia	finnland
ferito	verletzt
villaggi	dörfer
modificato	geändert
esistenti	bestehenden
esistenti	bestehende
law	law
phil	phil
nino	nino
invito	einladung
columbia	columbia
editoriale	redaktionelle
georges	georges
news	news
minuto	minute
miglia	meilen
pictures	pictures
grant	grant
situazioni	situationen
book	book
dover	dover
novara	novara
minor	minor
guy	guy
democrazia	demokratie
scoprire	entdecken
miguel	miguel
indagini	untersuchungen
indirizzo	adresse
jerry	jerry
moda	mode
partendo	ausgehend
richiede	erfordert
etc	etc
ridurre	reduzieren
raymond	raymond
fenomeni	phänomene
zelanda	seeland
prototipo	prototyp
allievo	kursteilnehmer
hard	hard
rosario	rosario
professione	beruf
fermata	haltestelle
virus	virus
virus	viren
conquistare	erobern
samuel	samuel
applicazioni	anwendungen
carter	carter
junior	junior
server	server
bassista	bassist
pesci	fische
esilio	exil
lisa	lisa
criterio	kriterium
sconosciuto	unbekannt
rick	rick
robot	roboter
apostolico	vikariat
bobby	bobby
momenti	momente
stewart	stewart
saggista	essayist
aragona	aragon
fiore	blume
sorpresa	überraschung
costantino	konstantin
definire	definieren
merci	waren
decorazioni	dekorationen
soldato	soldat
sintesi	zusammenfassung
ispirazione	inspiration
terreni	grundstücke
botanico	botanischen
bay	bay
census	census
chiude	schließt
astronomo	astronom
testimonianza	zeugnis
celeste	celeste
acquisto	kauf
woman	woman
type	type
lucas	lucas
sarah	sarah
affresco	fresko
calendario	kalender
barry	barry
potenti	mächtigen
laterale	seitliche
cresciuto	wuchs
bit	bit
figlie	töchter
adattamento	anpassung
mitologia	mythologie
herbert	herbert
riga	zeile
piacenza	piacenza
grigio	grau
botswana	botswana
bloccato	blockiert
pistola	pistole
nonno	großvater
queen	queen
norman	norman
perù	peru
fallimento	bankrott
specifiche	spezifischen
fedele	treu
taranto	taranto
juniores	junioren
nelson	nelson
sudafrica	südafrika
misto	gemischt
atteggiamento	haltung
obiettivi	ziele
definitivo	endgültig
donato	gespendet
vapore	dampf
naturalmente	natürlich
parker	parker
filo	draht
proteggere	schützen
conquistato	erobert
ian	ian
cugino	vetter
tesoro	schatz
armati	bewaffnet
mba	mba
sponsor	sponsoren
scegliere	wählen
profondo	tief
may	may
morgan	morgan
limitato	begrenzt
rugbista	rugbyspieler
coppie	paare
ita	ger
paradiso	paradies
margine	spielraum
spettacoli	shows
cronaca	chronik
light	light
citazione	zitat
deserto	wüste
spese	ausgaben
accettare	akzeptieren
lavorazione	verarbeitung
malattie	krankheiten
boys	boys
cat	cat
catturato	gefangen
gene	gene
lucca	lucca
corriere	kurier
liste	listen
differente	unterschiedlich
udine	udine
partigiano	partisan
pov	pov
terry	terry
probabilità	wahrscheinlichkeit
girls	girls
colombo	colombo
playstation	playstation
simboli	symbole
bowl	bowl
parlato	gesprochen
sostanze	stoffe
concezione	konzeption
dovevano	mussten
positivo	positiv
decorazione	dekoration
fiorentina	fiorentina
dovrebbero	sollten
cattolici	katholiken
circolare	rundschreiben
hitler	hitler
arresto	verhaftung
organizzazioni	organisationen
cross	cross
sorelle	schwestern
completato	abgeschlossen
neve	schnee
ruote	räder
asti	asti
ravenna	ravenna
arts	arts
vaticano	vatikan
calibro	kaliber
rango	rang
approccio	ansatz
stima	schätzung
scienziato	wissenschaftler
fire	fire
pazienti	patienten
armato	bewaffnet
distruggere	zerstören
passati	vergangen
marshall	marshall
uffici	büros
righe	zeilen
scultura	skulptur
varese	varese
inferno	hölle
risoluzione	auflösung
part	part
commenti	kommentare
saggi	weisen
freddo	kalt
stanley	stanley
pino	pino
onde	wellen
dea	göttin
dario	dario
pareggio	unentschieden
femmina	weiblich
lloyd	lloyd
bruxelles	brüssel
moon	moon
budapest	budapest
aviazione	luftfahrt
larry	larry
puglia	apulien
philip	philip
adottato	adoptiert
finito	fertig
pubblicità	werbung
demo	demo
more	more
occupato	beschäftigt
occupato	besetzt
mito	mythos
testimonianze	zeugnisse
marine	marine
radici	wurzeln
ella	ella
bolzano	bozen
jay	jay
vietnam	vietnam
tommy	tommy
colombia	kolumbien
dichiarazione	erklärung
georgia	georgien
esperti	experten
lombardo	lombardo
ann	ann
parlamentare	parlamentarischen
signori	herren
ginevra	genf
serbo	serbisch
difendere	verteidigen
god	god
architetture	architekturen
denti	zähne
niccolò	niccolò
equilibrio	gleichgewicht
continente	kontinent
tipicamente	gewöhnlich
side	side
iniziare	beginnen
archeologico	archäologische
luisa	luisa
veicolo	fahrzeug
insetti	insekten
isabella	isabella
sviluppare	entwickeln
discutere	diskutieren
duo	duo
lawrence	lawrence
cristianesimo	christentum
costumi	kostüme
times	times
pablo	pablo
patriota	patriot
venerdì	freitag
gallo	hahn
accompagnato	begleitet
messicano	mexikanischen
stuart	stuart
scudo	schild
precisione	genauigkeit
vedova	witwe
curva	kurve
angel	angel
scaduto	abgelaufen
manchester	manchester
marche	marken
get	get
russi	russen
mariano	mariano
gonzaga	gonzaga
visconti	visconti
when	when
meccanismo	mechanismus
pagamento	zahlung
todd	todd
lost	lost
testamento	testament
ricevere	empfangen
gonzález	gonzález
roman	roman
produzioni	produktionen
potenziale	potenzial
ibn	ibn
anton	anton
soluzioni	lösungen
cena	abendessen
sebastiano	sebastiano
rurale	ländliche
viaggi	reisen
ospiti	gäste
distrutta	zerstört
victoria	victoria
volley	volley
ebraico	hebräisch
musei	museen
lire	lire
wilhelm	wilhelm
coscienza	gewissen
movie	movie
alfa	alpha
siracusa	syrakus
baia	bucht
blocchi	blöcke
interessato	interessiert
tito	tito
nfl	nfl
frammenti	fragmente
spirituale	spirituelle
monaci	mönche
superato	bestanden
erba	gras
age	age
convocato	einberufen
apparentemente	scheinbar
frazioni	fraktionen
metallo	metall
raggi	speichen
tende	zelte
sottospecie	unterart
raggruppa	gruppieren
lecce	lecce
dottrina	lehre
microsoft	microsoft
denis	denis
lópez	lópez
dream	dream
offensiva	offensive
benjamin	benjamin
ritirata	zurückgezogen
fattore	faktor
barocco	barock
temporale	gewitter
marvel	marvel
adulti	erwachsene
anonimo	anonym
danny	danny
parametri	parameter
grazia	gnade
gay	homosexuell
armando	armando
roccia	felsen
finestra	fenster
undici	elf
eredità	erbe
funzionamento	funktionieren
paziente	patient
dramma	drama
ron	ron
fotografo	fotograf
corretta	ordnungsgemäße
broadway	broadway
cannone	kanone
lezioni	lektionen
videoclip	videoclips
camillo	camillo
serra	serra
hong	hong
dottore	doktor
ville	villen
dragon	dragon
domande	fragen
miami	miami
fossili	fossilen
monza	monza
franchi	franken
automobilistico	autohersteller
eroi	helden
reno	rhein
uova	eier
rappresentare	repräsentieren
rappresentare	vertreten
taglio	schnitt
arabi	araber
harris	harris
convenzione	übereinkommen
emma	emma
jon	jon
wright	wright
garcía	garcía
vetta	gipfel
universal	universal
mettendo	indem
calore	wärme
cratere	krater
cooper	cooper
collo	hals
buoni	gutscheine
rotazione	rotation
settori	bereichen
soprano	soprano
albanese	albanische
popolarità	popularität
lake	lake
logica	logik
pallavolista	volleyballspieler
grotta	höhle
giocando	spielend
segnato	markiert
commons	commons
european	european
monica	monica
let	let
economici	billig
murray	murray
moderne	moderne
dino	dino
draft	draft
viva	viva
scoppio	knall
borbone	bourbon
teologia	theologie
nate	nate
antichità	antiquitäten
walker	walker
consumo	verbrauch
valido	gültig
rimini	rimini
martina	martina
novità	neuheiten
percentuale	prozentsatz
mussolini	mussolini
css	css
opposto	entgegengesetzt
greg	greg
assist	assist
stadium	stadium
compiti	aufgaben
warner	warner
pietre	steine
spezia	spezia
municipio	rathaus
malta	malta
valli	täler
metro	metro
volontari	freiwillige
rispondere	beantworten
temperature	temperaturen
mtv	mtv
patriarca	patriarchen
parentesi	klammern
scavi	ausgrabungen
donald	donald
second	second
vladimir	wladimir
esploratore	forscher
coalizione	koalition
suore	nonnen
maschera	maske
genio	genie
galles	wales
matrice	matrix
maría	maría
dettaglio	detail
legione	legion
dean	dean
calcolo	berechnung
ribelli	rebellen
dispositivo	gerät
austin	austin
liquido	flüssig
stefan	stefan
massiccio	massive
sperimentale	experimentelle
wrestler	wrestler
campbell	campbell
salita	aufstieg
regolamento	verordnung
margaret	margaret
amato	liebte
rizzoli	rizzoli
assassino	mörder
radicale	radikal
decine	dutzende
mac	mac
notato	bemerkt
spiaggia	strand
aka	aka
informatica	informatik
flora	flora
nobiltà	adel
divina	göttliche
omaggio	hommage
ruota	rad
castiglia	kastilien
nascosto	versteckt
vetro	glas
soul	soul
giornali	zeitungen
fifa	fifa
giardini	gärten
dna	dna
affermazione	behauptung
renzo	renzo
georg	georg
valerio	valerio
debole	schwach
maresciallo	marschall
newton	newton
revisione	überprüfung
palla	ball
pesca	fischerei
sessione	tagung
messi	messi
aiuta	hilft
individuo	einzelperson
variazioni	veränderungen
feriti	verletzte
studente	student
discipline	disziplinen
podio	podium
trazione	traktion
carabinieri	carabinieri
family	family
litri	liter
quaranta	vierzig
graham	graham
people	people
comparsa	auftreten
rené	rené
sfera	sphäre
sara	sara
raccogliere	sammeln
efficace	effektiv
ama	liebt
disambigua	begriffsklärung
porzione	teil
diana	diana
bbc	bbc
rivale	rivalen
cupola	kuppel
prossimo	nächster
airlines	airlines
accusato	angeklagt
principato	fürstentum
orlando	orlando
ralph	ralph
segnalare	melden
ambasciatore	botschafter
platino	platin
contribuito	beigetragen
filippine	philippinen
toronto	toronto
pseudonimo	pseudonym
ppa	kkp
sbagliato	falsch
fascismo	faschismus
hugo	hugo
nuoto	schwimmen
terminato	beendet
angela	angela
osservazioni	bemerkungen
cattura	fang
place	place
zampe	pfoten
four	four
archeologici	archäologischen
neil	neil
billboard	billboard
equivalente	gleichwertig
lorena	lothringen
artificiale	künstliche
dibattito	debatte
fiction	fiktion
esplosione	explosion
jersey	jersey
promuovere	fördern
geografica	geografischen
elio	helium
economista	ökonom
meta	meta
sindrome	syndrom
youtube	youtube
just	just
dimissioni	rücktritt
gianfranco	gianfranco
seminario	seminar
rami	zweige
rifiuta	weigert
configurazione	konfiguration
achille	achilles
viale	allee
ammesso	zugegeben
gioventù	jugend
lettore	leser
composizioni	kompositionen
now	now
acustica	akustik
nazista	nazi
coraggio	mut
settima	siebte
nova	nova
casale	casale
cattivo	böse
parenti	verwandte
chan	chan
lanciato	gestartet
mostrato	gezeigt
pozzo	brunnen
aggiunge	fügt
diario	tagebuch
crescente	wachsende
buono	gut
legislatura	wahlperiode
arnold	arnold
forum	forum
three	three
dennis	dennis
trio	trio
separazione	trennung
spiegare	erklären
serbia	serbien
dilettanti	amateure
sandro	sandro
cade	fällt
carro	wagen
derby	derby
formati	formate
contessa	gräfin
sentenza	urteil
professionisti	profis
tonnellate	tonnen
ted	ted
mercedes	mercedes
delta	delta
piace	gefällt
colonie	kolonien
only	only
provare	versuchen
batman	batman
claudia	claudia
neo	neo
creature	kreaturen
arturo	arturo
comprendere	verstehen
marcel	marcel
cassa	kasse
organizzare	organisieren
trasformato	verwandelt
eduardo	eduardo
martín	martín
chiamate	anrufe
anniversario	jahrestag
perry	perry
piacere	vergnügen
wwe	wwe
bilancio	haushalt
premier	premier
vicario	vikar
sceriffo	sheriff
bobina	spule
ottavo	achten
campania	kampanien
alessio	alessio
arcipelago	archipel
blood	blood
sea	sea
salva	speichern
maddalena	magdalena
tecnologie	technologien
mantenimento	aufrechterhaltung
tappe	etappen
rodolfo	rodolfo
croato	kroatisch
busto	büste
nintendo	nintendo
supercoppa	supercup
negozio	laden
verticale	vertikale
autonomo	selbständig
autonomo	autonomen
sorgente	quelle
extra	extra
cremona	cremona
jacopo	jacopo
spinta	erhöhung
calci	treten
indagine	untersuchung
strano	seltsam
terapia	therapie
pete	pete
janeiro	janeiro
insegna	lehrt
registrazioni	aufzeichnungen
luke	luke
schiavi	sklaven
boschi	wälder
amministratori	administratoren
point	point
harold	harold
curiosità	neugier
robinson	robinson
matthew	matthew
radar	radar
complessi	komplexe
dedica	widmet
penale	strafrechtlichen
guinea	guinea
baker	baker
tragedia	tragödie
alternative	alternativen
registrati	registriert
curato	gepflegt
leggero	leicht
dallas	dallas
mitchell	mitchell
marte	mars
sconfiggere	besiegen
philippe	philippe
monumentale	monumentale
colin	colin
attivi	aktive
cinquecento	cinquecento
milione	million
negativo	negativ
rally	rallye
perfetto	perfekt
laghi	seen
borsa	tasche
riserve	reserven
declino	rückgang
ispettore	inspektor
strategia	strategie
conservata	aufbewahrt
bomba	bombe
uccello	vogel
flavio	flavio
intensità	intensität
discografia	diskographie
deposito	hinterlegung
salone	salon
core	core
appello	appell
braccia	arme
abside	apsis
venere	venus
tempesta	sturm
brillante	brillant
pala	schaufel
insediamenti	siedlungen
trentino	trentino
never	never
quindici	fünfzehn
pat	pat
pioggia	regen
caldo	heiß
stagionale	saisonale
teorema	satz
zurigo	zürich
pubblicare	veröffentlichen
turchi	türken
impiegati	angestellte
days	days
volere	wollen
croazia	kroatien
mari	mari
processione	prozession
fiorentino	fiorentino
determinare	bestimmen
anelli	ringe
tendenza	trend
autostrada	autobahn
magistrato	magistrat
bot	bot
ponti	brücken
equazione	gleichung
rita	rita
canta	singt
causato	verursacht
massimiliano	maximilian
sebastian	sebastian
apollo	apollo
silver	silver
regolarmente	regelmäßig
flauto	flöte
bibbia	bibel
ludwig	ludwig
forlì	forlì
thompson	thompson
contadini	bauern
strato	schicht
rottura	bruch
binario	gleis
cortile	innenhof
have	have
project	project
griffith	griffith
competenza	zuständigkeit
avvento	advent
ecclesiastica	kirchliche
costume	kostüm
scopi	zwecke
sentiero	weg
frasi	sätze
cervello	gehirn
appartamento	wohnung
spostamento	verschiebung
concesso	gewährt
preciso	präzise
abruzzo	abruzzen
archeologo	archäologe
fila	reihe
peccato	schade
caratteristico	charakteristisch
citazioni	zitate
valley	valley
organismo	organismus
esecutivo	exekutive
hunter	hunter
genovese	genovese
boris	boris
nastro	band
esperimenti	experimente
info	info
latte	milch
biennale	biennale
albania	albanien
pechino	peking
jorge	jorge
pescara	pescara
iran	iran
delitto	verbrechen
diploma	diplom
joan	joan
conversione	umwandlung
immaginario	imaginären
augusta	augsburg
serena	serena
ottava	achte
ospitato	untergebracht
partner	partner
fiera	messe
apparizioni	erscheinungen
discendenti	nachkommen
andreas	andreas
ristrutturazione	umstrukturierung
secret	secret
regni	königreiche
antoine	antoine
field	field
sogni	träume
consigli	tipps
guerriero	krieger
siria	syrien
jacob	jacob
sottile	dünn
collegato	verbunden
bombardamento	bombardierung
rigore	strenge
slam	slam
julie	julie
istruzioni	anweisungen
alleato	verbündeten
mobili	möbel
hip	hip
she	she
traduttore	übersetzer
rivelato	ergeben
accuse	anschuldigungen
summer	summer
osservare	beobachten
touchdown	touchdown
detroit	detroit
ritmo	tempo
collaborare	zusammenarbeiten
lugano	lugano
inventore	erfinder
prosa	prosa
formale	förmlichen
stoccolma	stockholm
simpson	simpson
kennedy	kennedy
prussia	preußen
appartengono	gehören
leonard	leonard
cruz	cruz
dispositivi	geräte
statuto	satzung
statuto	statut
miglioramento	verbesserung
vuelta	vuelta
rivoluzionario	revolutionär
scacchi	schach
consegna	lieferung
formalmente	formal
amedeo	amedeo
missili	raketen
soprannome	spitzname
take	take
derivato	abgeleiteten
talento	talent
stop	stop
liguria	ligurien
varsavia	warschau
marocco	marokko
preghiera	gebet
conflitti	konflikte
business	business
iniziative	initiativen
evans	evans
riproduzione	wiedergabe
there	there
striscia	streifen
nudo	nackt
integrazione	integration
pane	brot
sensi	sinne
laureato	absolvent
mini	mini
kate	kate
parrocchie	pfarreien
head	head
dos	dos
houston	houston
rob	rob
amichevole	freundlich
emergenza	notfall
susan	susan
suona	klingt
ottomano	osmanischen
amy	amy
pomeriggio	nachmittag
distinzione	unterscheidung
jennifer	jennifer
spostare	verschieben
mayer	mayer
potter	potter
nancy	nancy
droga	droge
iraq	irak
liberale	liberal
foggia	foggia
sedi	gremien
sapore	geschmack
ferma	halt
arrondissement	arrondissement
redazione	redaktion
sean	sean
opinioni	meinungen
piemontese	piemontesischen
atlantico	atlantik
leopoldo	leopoldo
cuba	kuba
cella	zelle
completare	vervollständigen
sol	sol
bombe	bomben
caro	lieber
mulino	mühle
michelangelo	michelangelo
religioni	religionen
century	century
adatto	passend
funziona	funktioniert
mantiene	hält
mantiene	behält
mantiene	unterhält
palio	palio
her	her
martini	martini
mezza	halbe
manutenzione	wartung
pratiche	praktiken
riconoscere	erkennen
justin	justin
about	about
debuttato	debütierte
concentrazione	konzentration
mamma	mutter
chuck	chuck
sassofono	saxophon
mira	mira
gioia	freude
locomotive	lokomotiven
betty	betty
specchio	spiegel
warren	warren
lineare	lineare
cittadinanza	staatsangehörigkeit
collins	collins
rame	kupfer
pianeti	planeten
kurt	kurt
accreditato	akkreditiert
accreditato	gutgeschrieben
finora	bisher
bulgaria	bulgarien
fucile	gewehr
settimanale	wöchentliche
falso	fake
prince	prince
carmine	carmine
cattedra	lehrstuhl
supera	übertrifft
risposte	antworten
dylan	dylan
promessa	versprechen
tentato	versucht
discendente	nachkomme
concetti	konzepte
decisioni	entscheidungen
sec	sec
delegazione	delegation
reazioni	reaktionen
farina	mehl
telefono	telefon
tredici	dreizehn
arezzo	arezzo
racing	racing
rimbalzi	rebounds
lisbona	lissabon
assente	abwesend
disegnatore	zeichner
apple	apple
keith	keith
doc	doc
scoperte	entdeckungen
segnalato	berichtete
attentato	anschlag
port	port
amburgo	hamburg
convincere	überzeugen
autobus	bus
coperto	abgedeckt
catherine	catherine
confusione	verwirrung
cantanti	sänger
kansas	kansas
grosseto	grosseto
stars	stars
adozione	adoption
adozione	annahme
trent	trent
vicepresidente	vizepräsidentin
bagno	badezimmer
scherma	fechten
padrone	meister
guardie	wachen
ruggero	ruggero
improvvisamente	plötzlich
concorrenti	wettbewerber
ricardo	ricardo
beatrice	beatrice
división	división
cresce	wächst
caffè	kaffee
giurisprudenza	rechtsprechung
bonaparte	bonaparte
potenze	mächte
conduttrice	moderatorin
ossigeno	sauerstoff
variabili	variablen
raggiunta	erreicht
nizza	nizza
carbonio	kohlenstoff
agire	handeln
attaccato	angegriffen
edwards	edwards
alfabeto	alphabet
avessero	hätten
indicazione	angabe
seicento	seicento
lione	lyon
helen	helen
integrare	integrieren
gamba	bein
mountain	mountain
montaggio	montage
continuità	kontinuität
islam	islam
inc	inc
attivista	aktivist
creatura	kreatur
vestito	kleid
blake	blake
pietà	mitleid
ercole	herkules
apparire	erscheinen
minerale	mineral
austro	österreichisch
são	são
approvazione	genehmigung
cronache	chroniken
austriaci	österreicher
polvere	pulver
model	model
franklin	franklin
nicolò	nicolò
sony	sony
serial	serial
mago	zauberer
luci	lichter
galassia	galaxie
cani	hunde
primato	vorrang
harrison	harrison
want	want
dialetti	dialekte
combinazione	kombination
legami	bindungen
magic	magic
gianluca	gianluca
sculture	skulpturen
blog	blog
cronometro	stoppuhr
rafael	rafael
proteine	proteine
venezuela	venezuela
pose	posen
charlotte	charlotte
congo	kongo
ram	ram
prefetto	präfekt
domani	morgen
emittente	emittenten
león	león
studioso	gelehrter
operatore	betreiber
roland	roland
farmaci	medikamente
parallelo	parallel
assassinio	ermordung
rinascimento	renaissance
poliziotto	cop
inno	hymne
andrej	andrej
sat	sat
major	major
classic	classic
linda	linda
fisso	festen
giuria	jury
roll	roll
olivier	olivier
voli	flüge
strega	hexe
presentare	vorzulegen
normandia	normandie
benevento	benevento
tradimento	verrat
spiegato	erklärt
aumenta	erhöht
prof	prof
maglie	maschen
innamorato	verliebt
scomparso	vermisst
franca	franca
demone	dämon
scale	treppen
scale	treppe
delegato	delegierten
fernández	fernández
earth	earth
pastore	pastor
bernardino	bernardino
inediti	unveröffentlichte
designer	designer
turner	turner
farmaco	medikation
asta	auktion
cerchio	kreis
volante	lenkrad
sabbia	sand
spencer	spencer
modulo	modul
clinica	klinik
khan	khan
scandalo	skandal
sintomi	symptome
dintorni	umgebung
url	url
annata	jahrgang
globale	globalen
flash	flash
express	express
decorato	dekoriert
pennsylvania	pennsylvania
rumeno	rumänisch
carmen	carmen
padri	väter
spareggio	tiebreak
wood	wood
giurisdizione	gerichtsstand
spider	spider
spiegazione	erklärung
incisore	graveur
sbarco	anlandung
caroline	caroline
tromba	trompete
trapani	trapani
intelligenza	intelligenz
lunedì	montag
johan	johan
cantiere	baustelle
ricci	ricci
bloccare	blockieren
stan	stan
esperimento	experiment
ballerina	tänzerin
siciliana	sizilianische
ordinamento	sortierung
ordinamento	sortieren
brad	brad
accettato	akzeptiert
cuneo	keil
orecchie	ohren
apparve	erschien
roberts	roberts
grafico	schaubild
atlanta	atlanta
radice	wurzel
giornalisti	journalisten
belgrado	belgrad
savona	savona
heavy	heavy
osservatorio	beobachtungsstelle
misterioso	mysteriösen
alpina	alpina
influenze	einflüsse
notorietà	bekanntheit
prefazione	vorwort
salvador	salvador
propaganda	propaganda
odio	hasse
christmas	christmas
influenzato	beeinflusst
influenzato	beeinflußt
ricchezza	reichtum
rifiuto	ablehnung
hills	hills
deep	deep
domini	domains
liverpool	liverpool
gestito	verwaltet
net	net
contrada	contrada
suoni	klingt
riconosce	erkennt
iron	iron
capocannoniere	torschützenkönig
musulmani	muslime
servita	serviert
arcangelo	erzengel
quadrato	quadrat
shakespeare	shakespeare
mafia	mafia
crocifisso	gekreuzigt
sforzi	bemühungen
netto	netto
erik	erik
sforzo	anstrengungen
mostri	monster
distingue	unterscheidet
recensione	rezension
nobel	nobel
indossa	trägt
craig	craig
kid	kid
addio	abschied
eleonora	eleonora
crescere	wachsen
pavel	pavel
vegetazione	vegetation
lincoln	lincoln
brindisi	toast
armenia	armenien
brothers	brothers
pistoia	pistoia
distinti	getrennte
act	act
codici	codes
costantemente	ständig
pellegrini	pilger
kent	kent
intenso	intensiv
comandi	befehle
ottica	optik
baden	baden
une	une
visibilità	sichtbarkeit
salvato	gespeichert
pilastri	säulen
gotico	gotischen
ward	ward
coordinate	koordinaten
dieta	diät
gustavo	gustavo
copenaghen	kopenhagen
cairo	kairo
rovine	ruinen
centre	centre
ricorso	klage
appuntamento	date
other	other
sidney	sidney
registro	register
documentazione	dokumentation
hermann	hermann
chitarre	gitarren
dorsale	dorsalen
tavolo	tisch
raccolto	ernte
nonna	oma
justice	justice
bulgaro	bulgarisch
nicole	nicole
anglo	anglo
banco	banco
dominante	beherrschenden
honda	honda
albergo	hotel
altrove	anderswo
sondaggio	umfrage
santos	santos
moro	moro
grace	grace
alo	alo
beta	beta
gennaro	gennaro
spostato	verschoben
valentino	valentino
liberare	befreien
wolfgang	wolfgang
pan	pan
barca	boot
nicholas	nicholas
partecipazioni	beteiligungen
sweet	sweet
drammatico	dramatisch
jesse	jesse
raimondo	raimondo
stabilità	stabilität
sinonimo	synonym
percorsi	wege
jessica	jessica
brooklyn	brooklyn
cilindrata	hubraum
motto	motto
gesto	geste
scorre	fließt
wta	wta
conservatorio	konservatorium
atterraggio	landung
jamie	jamie
ambrogio	ambrogio
fritz	fritz
clienti	kunden
reddito	einkommen
manufacturing	manufacturing
macedonia	mazedonien
orso	bär
operai	arbeiter
contare	zählen
coperta	decke
contribuire	beitragen
cappello	hut
renault	renault
corazzata	schlachtschiff
chiamare	anrufen
estratti	auszüge
castro	castro
silvia	silvia
sports	sports
diesel	diesel
apparteneva	gehörte
slovacchia	slowakei
sub	sub
riflessione	reflexion
vegas	vegas
ragno	spinne
share	share
carrozzeria	karosserie
dublino	dublin
lussemburgo	luxemburg
francoforte	frankfurt
inedito	unveröffentlicht
quadrati	quadrate
lucky	lucky
idrogeno	wasserstoff
rilasciato	ausgestellt
ottone	messing
orologio	uhr
disponibilità	verfügbarkeit
tunnel	tunnel
masters	masters
ascoli	ascoli
marrone	braun
ceramica	keramik
sassari	sassari
bravo	bravo
gravità	schwerkraft
legend	legend
cleveland	cleveland
strumentale	instrumental
madagascar	madagaskar
hit	hit
perdono	vergebung
julian	julian
partigiani	partisanen
edgar	edgar
raffaello	raphael
memorial	memorial
berlusconi	berlusconi
aurelio	aurelio
tifosi	fans
ucraino	ukrainisch
dog	dog
giù	unten
tessuti	gewebe
martínez	martínez
finalisti	finalisten
allan	allan
mina	mina
incrociatore	kreuzer
nacional	nacional
antonino	antonino
duello	duell
accade	geschieht
scenografo	bühnenbildner
suicidio	selbstmord
local	local
carbone	kohle
adriatico	adria
adrian	adrian
fiamme	flammen
comunisti	kommunisten
terribile	schrecklich
hell	hell
kiss	kiss
seattle	seattle
nathan	nathan
wang	wang
sedici	sechzehn
ref	ref
anticipo	voraus
philadelphia	philadelphia
levi	levi
crimine	verbrechen
empire	empire
taglia	größe
rettangolare	rechteckigen
riposo	ruhe
laser	laser
allenamento	training
ritratti	porträts
sergente	sergeant
invenzione	erfindung
ristorante	restaurant
porti	häfen
lemmon	lemmon
borghese	borghese
antologia	anthologie
historia	historia
ritardo	verzögerung
cancro	krebs
louise	louise
lima	lima
bande	banden
mostrare	zeigen
cappelle	kapellen
beata	beata
years	years
werner	werner
pontefice	pontifex
marsiglia	marseille
into	into
prete	priester
marcos	marcos
cadavere	leiche
periferia	peripherie
cranio	schädel
nono	neunten
cosenza	cosenza
sguardo	blick
borgogna	burgund
orizzontale	horizontale
catturare	erfassen
assisi	assisi
strati	schichten
campana	glocke
hart	hart
frederick	frederick
tombe	gräber
studia	studiert
gambe	beine
puro	reinen
miles	miles
connessione	verbindung
var	var
marcus	marcus
rappresentanza	vertretung
anziani	senioren
predecessore	vorgänger
canne	schilf
intellettuale	geistigen
full	full
efficacia	wirksamkeit
spot	spot
batterie	batterien
minnesota	minnesota
collezioni	sammlungen
gigi	gigi
riservato	reserviert
manoscritto	manuskript
jake	jake
completamento	abschluss
acronimo	akronym
murphy	murphy
premiato	preisgekrönte
armatura	rüstung
allevamento	zucht
statistica	statistik
laterza	laterza
aaron	aaron
jules	jules
prestigio	prestige
main	main
munizioni	munition
votato	gestimmt
trionfo	triumph
identificato	identifiziert
ohio	ohio
approvato	genehmigt
organizzatore	veranstalter
interpretare	interpretieren
glenn	glenn
vertici	gipfeltreffen
industrie	industrien
gemelli	zwillinge
invitato	eingeladen
trasferta	auswärts
presumibilmente	angeblich
meccanico	mechaniker
lane	lane
trilogia	trilogie
servire	dienen
torres	torres
temporaneamente	vorübergehend
virgilio	virgilio
grassi	fette
panzer	panzer
cecilia	cecilia
sopravvissuti	überlebende
acquisizione	erwerb
morris	morris
depressione	depression
dirigenti	führungskräfte
javier	javier
spessore	dicke
identificazione	identifizierung
petto	brust
circostanze	umstände
igor	igor
descrivere	beschreiben
devil	devil
interpretazioni	interpretationen
biografie	biographien
pavimento	fußboden
car	car
zucchero	zucker
pdc	pdc
neozelandese	neuseeländische
este	este
clero	klerus
rappresentazioni	darstellungen
frontale	frontal
ordinario	ordentlichen
pérez	pérez
hugh	hugh
again	again
eserciti	armeen
specializzata	spezialisiert
variazione	veränderung
away	away
sospensione	aussetzung
pirati	piraten
veneziano	venezianischen
wallace	wallace
loggia	loggia
pesaro	pesaro
sultano	sultan
toro	stier
superman	superman
mass	mass
emissione	emission
they	they
after	after
ferite	wunden
kiev	kiew
phoenix	phoenix
alluminio	aluminium
vendere	verkaufen
datato	datiert
corno	horn
piatti	teller
futuri	künftigen
protesta	protest
rachel	rachel
immacolata	makellos
intellettuali	intellektuelle
grey	grey
elia	elia
manifesto	manifest
fedeltà	treue
stavolta	diesmal
raw	raw
integrato	integriert
tomáš	tomáš
watson	watson
interfaccia	schnittstelle
terrore	terror
mod	mod
reynolds	reynolds
martiri	märtyrer
istanbul	istanbul
colorado	colorado
continuato	fortgesetzt
colorazione	färbung
etiopia	äthiopien
sandra	sandra
soggiorno	aufenthalt
illinois	illinois
orleans	orleans
spalla	schulter
challenge	challenge
scipione	scipio
bach	bach
bros	bros
phillips	phillips
sloveno	slowenisch
call	call
scalo	zwischenlandung
geometria	geometrie
biagio	biagio
millennio	millennium
giganti	riesen
zia	tante
rimosso	entfernt
our	our
traduzioni	übersetzungen
happy	happy
seguirono	folgten
estrazione	extraktion
accompagnamento	begleitung
minerali	mineralien
ticino	tessin
mondi	welten
mozart	mozart
distinguere	unterscheiden
bmw	bmw
campionessa	meisterin
monarchia	monarchie
adolfo	adolfo
installazione	installation
salire	steigen
spin	spin
michigan	michigan
violoncello	cello
applicata	angewandte
passano	vergehen
monferrato	monferrato
ampliare	erweitern
joão	joão
leon	leon
alexandre	alexandre
grotte	höhlen
alessandra	alessandra
assi	achsen
filologo	philologe
ostilità	feindseligkeit
rodríguez	rodríguez
hop	hop
compleanno	geburtstag
ernest	ernest
carrara	carrara
return	return
cecil	cecil
governi	regierungen
esistere	existieren
pallone	ballon
arizona	arizona
wagner	wagner
cristallo	kristall
vercelli	vercelli
annibale	hannibal
crollo	zusammenbruch
cosimo	cosimo
body	body
affetto	zuneigung
amanda	amanda
picco	peak
negozi	geschäfte
rca	rca
dit	dit
ignazio	ignazio
ronald	ronald
retro	rückseite
naso	nase
melbourne	melbourne
pastorale	pastoralen
peste	pest
ghost	ghost
harvey	harvey
isaac	isaac
pausa	zeitrechnung
razze	rassen
know	know
hunt	hunt
coloni	siedler
testimone	zeuge
mercati	märkte
viceversa	umgekehrt
tele	tele
palmer	palmer
reed	reed
emily	emily
acquisito	erworben
rivalità	rivalität
pellicole	filme
hms	hms
reality	reality
transizione	übergang
taiwan	taiwan
bye	bye
circondato	umgeben
pour	pour
cardinali	kardinäle
müller	müller
xxi	xxi
cantato	gesungen
freccia	pfeil
stellare	stellar
colpevole	schuldig
protocollo	protokoll
claire	claire
folla	menge
libia	libyen
television	television
uniforme	uniform
josh	josh
ribellione	rebellion
fausto	fausto
dimostrazione	demonstration
impressione	eindruck
run	run
duchessa	herzogin
gallese	walisischen
tell	tell
carmelo	carmelo
invita	fordert
omicidi	morde
residente	wohnhaft
umbria	umbrien
holmes	holmes
diga	damm
reato	straftat
militante	militanten
sismica	seismische
contemporaneo	zeitgenössischen
class	class
trasformare	verwandeln
got	got
attuazione	umsetzung
gregory	gregory
procuratore	staatsanwalt
rinunciare	aufgeben
menzione	erwähnung
verbo	verb
creatore	schöpfer
leva	hebel
macchia	fleck
intenzioni	absichten
rudolf	rudolf
soglia	schwelle
hope	hope
pirenei	pyrenäen
rajon	rajon
nuotatore	schwimmer
rivali	rivalen
manoscritti	manuskripte
rettore	rektor
folk	folk
beatles	beatles
bombardamenti	bombardierungen
lou	lou
tubo	rohr
decisivo	entscheidend
impostazione	einstellung
canonico	kanonische
rex	rex
giove	jupiter
comprensione	verständnis
vangelo	evangelium
cesena	cesena
rogers	rogers
imperatrice	kaiserin
ieri	gestern
poetica	poetische
pericoloso	gefährlich
view	view
true	true
secondario	sekundären
slovenia	slowenien
gaio	gaius
organista	organist
crociera	tempomat
sonic	sonic
anteprima	vorschau
carol	carol
han	han
pura	reine
inaugurazione	eröffnung
adolf	adolf
correre	laufen
orale	mündliche
rione	rione
eccezionalmente	ausnahmsweise
beat	beat
sprint	sprint
dinamo	dynamo
liberty	liberty
trinità	dreifaltigkeit
guillermo	guillermo
gallia	gallia
australian	australian
violento	gewalttätig
riforme	reformen
cipro	zypern
bird	bird
demoni	dämonen
massachusetts	massachusetts
corde	seile
presidenti	präsidenten
carità	nächstenliebe
leggende	legenden
saverio	saverio
molecole	moleküle
sacrificio	opfer
architetti	architekten
cava	steinbruch
sospetto	verdacht
terminale	terminal
lombardi	lombardi
benzina	benzin
zar	zar
five	five
rispettare	respektieren
olanda	niederlande
generazioni	generationen
hal	hal
derivati	derivate
cantare	singen
referendum	referendum
fischio	pfeifen
lodi	lob
contee	grafschaften
teramo	teramo
indie	indie
suite	suite
qualifica	qualifikation
guillaume	guillaume
lino	flachs
ira	ira
make	make
curtis	curtis
enormi	enorme
efficienza	effizienz
nina	nina
veneta	veneta
nodo	knoten
heaven	heaven
unire	verbinden
ostacoli	hindernisse
sinfonia	symphonie
pasta	pasta
massacro	massaker
rolling	rolling
leoni	löwen
convegno	konferenz
boemia	böhmen
ginnastica	gymnastik
identificare	identifizieren
amanti	liebhaber
mason	mason
odore	geruch
marca	marke
bridge	bridge
alain	alain
frutta	obst
succedette	beerbte
algeria	algerien
calice	kelch
organico	organischen
estinzione	aussterben
girare	drehen
trattare	behandeln
catene	ketten
rimuovere	entfernen
eyes	eyes
ultimate	ultimate
face	face
sinonimi	synonyme
vettore	vektor
appassionato	leidenschaftlich
mons	mons
fabbricato	hergestellt
sensibilità	empfindlichkeit
dominazione	dominanz
gola	kehle
annuario	jahrbuch
irene	irene
soap	soap
mvp	mvp
sfuggire	entkommen
gatti	katzen
cameron	cameron
naturalista	naturforscher
cintura	gürtel
gorizia	görz
uccisione	tötung
marziale	martial
giovan	giovan
parchi	parks
attacca	greift
distanze	entfernungen
abbandona	verlässt
uruguay	uruguay
felix	felix
cook	cook
birra	bier
mitragliatrici	maschinengewehre
fallito	versagt
sviluppi	entwicklungen
dita	finger
klaus	klaus
altopiano	hochebene
sierra	sierra
screenshot	screenshot
rivolto	gerichtet
confessa	gesteht
knight	knight
jeremy	jeremy
elegante	elegant
copa	copa
but	but
becker	becker
adiacente	angrenzenden
cannes	cannes
volare	fliegen
democratici	demokraten
pontificia	päpstliche
hepworth	hepworth
tubi	rohre
scafo	rumpf
positivi	positiven
money	money
ricercatori	forscher
consorzio	konsortium
mensile	monatlich
trek	trek
rookie	rookie
amor	amor
provenienza	herkunft
stili	stile
costanza	konstanz
par	par
povertà	armut
fibre	fasern
avellino	avellino
crociata	kreuzzug
españa	españa
beck	beck
xxx	xxx
caduto	gefallen
leslie	leslie
animato	animierte
animato	animiert
jedi	jedi
annunziata	annunziata
bizantina	byzantinischen
portava	trug
clara	clara
competenze	zuständigkeiten
quartetto	quartett
funzionario	beamter
productions	productions
prezzi	preise
rinuncia	verzicht
enzima	enzym
poetessa	dichterin
coloniale	kolonialen
gang	gang
lana	wolle
disastro	katastrophe
costanzo	costanzo
testimoni	zeugen
coltivazione	anbau
magnus	magnus
quattordici	vierzehn
water	water
considerazioni	erwägungen
straordinario	außerordentlichen
camere	zimmer
vicinanza	nähe
qualifiche	qualifikationen
archeologia	archäologie
apprezzato	geschätzt
solido	solide
catanzaro	catanzaro
muso	schnauze
apparente	scheinbare
owen	owen
kenneth	kenneth
randy	randy
controllato	überprüft
marta	marta
children	children
short	short
oslo	oslo
grammy	grammy
abbigliamento	kleidung
where	where
serpente	schlange
felicità	glück
particolarità	besonderheiten
illustrato	dargelegt
avvicina	nähert
most	most
straordinaria	außerordentliche
peggio	schlimmer
doria	doria
cittadine	bürgerinnen
cornice	rahmen
lapide	grabstein
urss	udssr
celebrato	gefeiert
territoriali	territorialen
hits	hits
vampiro	vampir
maturità	reife
maturità	abitur
recitazione	schauspielerei
drive	drive
corda	seil
ninja	ninja
triangolo	dreieck
incinta	schwanger
greatest	greatest
feltrinelli	feltrinelli
annessione	annexion
gallerie	galerien
cittadella	zitadelle
human	human
corsica	korsika
trophy	trophy
carnevale	karneval
impulso	impuls
lucy	lucy
lars	lars
genoa	genoa
urbino	urbino
powell	powell
mind	mind
lento	langsam
pacific	pacific
illustratore	illustrator
mars	mars
jonas	jonas
public	public
thailandia	thailand
rit	rit
radiazione	strahlung
sopravvivenza	überleben
caratterizza	kennzeichnet
xavier	xavier
visitatori	besucher
roberta	roberta
saltare	springen
laguna	laguna
bizantini	byzantiner
alpha	alpha
derek	derek
nestor	nestor
stoccarda	stuttgart
castiglione	castiglione
tullio	tullio
galli	galli
atlantic	atlantic
church	church
apostoli	apostel
walt	walt
volti	gesichter
cooperazione	zusammenarbeit
egiziano	ägyptischen
mississippi	mississippi
armeno	armenischen
miniere	bergbau
rilascio	erteilung
ashley	ashley
afghanistan	afghanistan
miranda	miranda
armistizio	waffenstillstand
attilio	attilio
pugno	faust
liegi	lüttich
astronomia	astronomie
masse	massen
ezio	ezio
forest	forest
depositi	einlagen
corruzione	korruption
direttiva	richtlinie
avviato	gestartet
spettro	spektrum
garcia	garcia
source	source
look	look
illuminazione	beleuchtung
doge	doge
singapore	singapur
fisher	fisher
minacce	bedrohungen
dovere	pflicht
armstrong	armstrong
mezzogiorno	mittag
mangiare	essen
aurora	aurora
trappola	falle
albano	albano
bucarest	bukarest
karen	karen
cortina	cortina
meccanismi	mechanismen
bang	bang
fattoria	farm
marinai	seeleute
camp	camp
barriera	barriere
petrolio	erdöl
mas	mas
protestante	protestantischen
jaime	jaime
primario	primäre
bin	bin
duncan	duncan
longobardi	langobarden
arancione	orange
legnano	legnano
lipsia	leipzig
orazio	orazio
tyler	tyler
elite	elite
joel	joel
combinata	kombinierten
incisione	gravur
wendy	wendy
stand	stand
incontrato	traf
assassinato	ermordet
quattrocento	quattrocento
sacramento	sacramento
disposizioni	bestimmungen
protetto	geschützt
carburante	kraftstoff
xbox	xbox
rabbia	zorn
julien	julien
edwin	edwin
kenny	kenny
spinto	gedrängt
uscite	ausgänge
seven	seven
foce	mündung
giovedì	donnerstag
manhattan	manhattan
finanziario	finanzielle
imparare	lernen
dignità	würde
rari	selten
romanico	romanik
cavità	hohlraum
espressioni	ausdrücke
debito	schuld
debito	schulden
commesso	begangen
iniziando	beginnend
hank	hank
adventures	adventures
falco	falken
torinese	torinese
foster	foster
lirica	lyrik
madame	madame
iscrizioni	aufdruck
marx	marx
daniela	daniela
storm	storm
fretta	eile
portaerei	flugzeugträger
polemica	kontroverse
elsa	elsa
battesimo	taufe
laurent	laurent
interazione	interaktion
diagnosi	diagnose
adulto	erwachsener
carla	carla
trasportare	transportieren
critics	critics
child	child
glasgow	glasgow
coast	coast
installato	installiert
hawaii	hawaii
reliquie	reliquien
dolci	süßen
shanghai	shanghai
malcolm	malcolm
pole	pole
poggio	poggio
evil	evil
operativi	operationellen
improvviso	plötzliche
dans	dans
censura	zensur
browser	browser
nasa	nasa
alonso	alonso
ducale	ducale
incrocio	kreuzung
eastern	eastern
stevens	stevens
doug	doug
gilles	gilles
imo	imo
pakistan	pakistan
rod	rod
invisibile	unsichtbar
ltd	ltd
mammiferi	säugetiere
superstiti	hinterbliebene
biologia	biologie
wall	wall
sonata	sonata
crema	creme
assia	hessen
vegetali	pflanzlichen
next	next
profeta	prophet
cartone	pappe
provenza	provence
scacchista	schachspieler
brigate	brigaden
incredibile	unglaublich
comunicare	kommunizieren
discreto	diskret
assegnazione	zuteilung
patricia	patricia
bond	bond
basilea	basel
censore	zensor
ana	ana
cerchi	felgen
rap	rap
sparta	sparta
persiano	persisch
six	six
cileno	chilenischen
visite	besuche
veronica	veronica
generare	generieren
valvole	ventile
tolosa	toulouse
maya	maya
pink	pink
raggiungibile	erreichbar
decima	zehnte
trascorso	verbracht
parodia	parodie
wells	wells
alejandro	alejandro
risposto	geantwortet
pasqua	ostern
made	made
too	too
marketing	marketing
ventura	ventura
etica	ethik
convoglio	konvoi
cole	cole
ribelle	rebell
dinamica	dynamik
trampolino	sprungbrett
emi	emi
montato	eingebaut
then	then
plastica	kunststoff
vantaggi	vorteile
risolto	gelöst
clarke	clarke
gun	gun
adottare	adoptieren
punte	spitzen
narrazione	erzählung
osservatore	beobachter
fair	fair
disturbi	störungen
diamante	diamant
quote	quoten
divino	göttlich
caos	chaos
divorzio	scheidung
shaw	shaw
globe	globe
volontario	freiwilliger
hughes	hughes
linux	linux
ivo	ivo
funzionale	funktionelle
alaska	alaska
tradurre	übersetzen
attribuzione	namensnennung
nunzio	nunzio
nicolás	nicolás
riti	riten
affermazioni	behauptungen
adesione	beitritt
angels	angels
indonesia	indonesien
doctor	doctor
appennino	appennino
applicato	angewandt
palatinato	pfalz
ovunque	überall
precipitazioni	niederschläge
processore	prozessor
nikolaj	nikolai
membrana	membran
richiamo	rückruf
banche	banken
piombo	blei
ripristino	wiederherstellung
largamente	weitgehend
gustav	gustav
nazisti	nazis
sita	sita
bon	bon
faro	leuchtturm
edimburgo	edinburgh
hood	hood
cripta	gruft
uovo	ei
rifiuti	abfall
rifiuti	abfälle
sysop	sysop
entrate	einnahmen
cancelliere	kanzler
primogenito	erstgeborenen
incidenti	unfälle
sonda	sonde
subiti	erlittenen
boeing	boeing
applicare	anwenden
livio	livio
grasso	fett
annuncio	anzeige
innumerevoli	unzählige
visitare	besuchen
collettivo	kollektiv
febbre	fieber
sella	sattel
cacciatore	jäger
seta	seide
ideali	ideale
primera	primera
liberali	liberalen
microregione	mikroregion
estetica	ästhetik
sonno	schlaf
copre	deckt
shadow	shadow
occupare	besetzen
chiostro	kreuzgang
incisioni	gravuren
lopez	lopez
rischi	risiken
rumore	lärm
palestina	palästina
ferdinand	ferdinand
rinascita	wiedergeburt
pompeo	pompeius
kyle	kyle
abc	abc
sciatore	skifahrer
scout	scout
eccessiva	übermäßige
attrazione	anziehung
divieto	verbot
earl	earl
nana	nana
intelligente	intelligente
minoranza	minderheit
navarra	navarra
abraham	abraham
meriti	verdienst
say	say
michail	michail
michelle	michelle
molecola	molekül
pallanuoto	wasserball
beautiful	beautiful
square	square
anversa	antwerpen
steel	steel
bompiani	bompiani
bacio	kuss
spara	schießt
elisa	elisa
sensibile	sensibel
mediaset	mediaset
generico	generisches
their	their
guarnigione	garnison
coll	coll
conteneva	enthielt
bureau	bureau
orsini	orsini
innocenzo	innocenzo
ramírez	ramírez
diamond	diamond
soccer	soccer
chang	chang
miniera	mine
umanista	humanist
onorario	honorar
selezionato	ausgewählt
nido	nest
belli	schön
bundesliga	bundesliga
riso	reis
volpe	fuchs
poker	poker
mortale	tödlichen
opzione	option
interviste	interviews
guitar	guitar
cantoni	kantone
denver	denver
pci	pci
württemberg	württemberg
board	board
baptiste	baptiste
vicente	vicente
preparare	vorbereiten
intel	intel
elettrici	elektrische
southern	southern
cicero	cicero
guidare	fahren
batte	schlägt
bonifacio	bonifacio
loira	loire
madison	madison
lupi	wölfe
abuso	missbrauch
capolinea	endstation
moretti	moretti
dirty	dirty
sosta	zwischenstopp
wisconsin	wisconsin
gesuita	jesuit
linguista	linguist
restaurato	restauriert
antifascista	antifaschistischen
tunisia	tunesien
joey	joey
sophie	sophie
povero	armer
turistico	touristischen
rivelazione	offenbarung
meyer	meyer
encyclopedia	encyclopedia
spia	spion
becco	klappe
becco	schnabel
combustibile	brennstoff
viso	gesicht
schiena	rücken
fiamma	flamme
risparmio	einsparungen
brooks	brooks
dorothy	dorothy
facebook	facebook
motion	motion
byron	byron
gómez	gómez
