annie	annie
fianchi	hüften
bull	bull
finanza	finanzen
deboli	schwache
metalli	metallen
chirurgia	chirurgie
diminuzione	rückgang
conferenze	konferenzen
andrés	andrés
loc	loc
vulcano	vulkan
dialoghi	dialoge
adelaide	adelaide
radiale	radialen
dirigere	leiten
schmidt	schmidt
ice	ice
molecolare	molekulare
sepoltura	begräbnis
cohen	cohen
tumore	tumor
break	break
granduca	großherzog
harvard	harvard
bolognese	bolognese
incoronazione	krönung
mantello	umhang
edge	edge
duchi	herzöge
sospetti	verdächtige
tributo	tribut
approfondimento	vertiefung
imposta	steuer
zhang	zhang
estone	estnisch
miti	mythen
tigre	tiger
portico	veranda
hudson	hudson
granata	granate
subsp	subsp
bordeaux	bordeaux
biblioteche	bibliotheken
amiche	freundinnen
corolla	corolla
emiliano	emiliano
combatte	kämpft
piazzale	piazzale
mercurio	quecksilber
martirio	martyrium
piattaforme	plattformen
uci	uci
montenegro	montenegro
missionario	missionar
vasco	vasco
damiano	damiano
remake	remake
passate	durchgemacht
burton	burton
birmingham	birmingham
row	row
fleming	fleming
determinazione	bestimmung
cold	cold
creek	creek
suddivisioni	unterteilungen
marchesi	marchesi
metallica	metallica
ruth	ruth
dee	dee
scartamento	spurweite
tip	tip
kane	kane
orléans	orléans
price	price
friends	friends
complessità	komplexität
cliff	cliff
cum	cum
chirurgo	chirurg
resistere	widerstehen
ecuador	ecuador
sainte	sainte
fiandre	flandern
viceré	vizekönig
cox	cox
numerazione	nummerierung
viterbo	viterbo
montevideo	montevideo
cantieri	werften
toledo	toledo
lombarda	lombarda
paulo	paulo
segmento	segment
teodoro	teodoro
ass	ass
sfocia	mündet
guadagnare	verdienen
sullivan	sullivan
consultato	konsultiert
jackie	jackie
turisti	touristen
mancini	mancini
duetto	duett
lara	lara
early	early
ellis	ellis
chiavi	schlüssel
difensiva	defensive
celle	zellen
magnetico	magnetischen
vivi	lebenden
vandalismo	vandalismus
nativo	native
punizione	strafe
martello	hammer
rangers	rangers
kingdom	kingdom
atomi	atome
muoversi	bewegen
pittsburgh	pittsburgh
caserma	kaserne
elicottero	hubschrauber
affluente	nebenfluss
offerte	angebote
rain	rain
montgomery	montgomery
trailer	trailer
marcelo	marcelo
cbs	cbs
helsinki	helsinki
mother	mother
caserta	caserta
lecco	lecco
brandon	brandon
medina	medina
donazione	spende
podestà	podestà
dawn	dawn
patti	patti
sequenze	sequenzen
walsh	walsh
hardcore	hardcore
helena	helena
another	another
pinacoteca	pinakothek
gil	gil
ladro	dieb
mel	mel
streghe	hexen
alias	alias
equazioni	gleichungen
percy	percy
electric	electric
sottolineare	betonen
superficiale	oberflächlich
kill	kill
were	were
papà	vater
complimenti	glückwunsch
faenza	faenza
sovranità	souveränität
presunta	angebliche
sergej	sergei
bottiglia	flasche
senior	senior
genesi	genesis
log	log
pereira	pereira
seduta	sitzung
altari	altäre
causare	verursachen
hero	hero
attraversare	überqueren
frammento	fragment
gibson	gibson
alieni	aliens
vini	weine
vinile	vinyl
avenue	avenue
incursioni	razzien
jenny	jenny
minoranze	minderheiten
distacco	entsendung
prefisso	präfix
cometa	komet
aquitania	aquitanien
comunicato	mitgeteilt
kit	kit
vampiri	vampire
dichiarazioni	erklärungen
agisce	handelt
accessibile	zugänglich
colombiano	kolumbianischen
ragusa	ragusa
separato	getrennt
mori	mori
sparare	schießen
correggere	korrigieren
esclusione	ausschluss
esclusione	ausgrenzung
duke	duke
rubrica	adressbuch
virtuale	virtuelle
danilo	danilo
generato	erzeugt
generato	generiert
capua	capua
funzionari	beamten
fighter	fighter
wonder	wonder
wade	wade
gravidanza	schwangerschaft
variare	variieren
contrabbasso	kontrabass
fugge	flieht
algoritmo	algorithmus
riscatto	lösegeld
marion	marion
ferreira	ferreira
consulente	berater
edmund	edmund
fitzgerald	fitzgerald
corazzate	schlachtschiffe
abu	abu
tastierista	keyboarder
versailles	versailles
slovacco	slowakisch
malato	krank
manda	schick
pagani	heiden
sandy	sandy
nature	nature
libano	libanon
isolamento	isolierung
consegnato	geliefert
jana	jana
martedì	dienstag
harper	harper
galeazzo	galeazzo
campane	glocken
chieti	chieti
heinz	heinz
automobili	autos
elettroni	elektronen
compromesso	kompromiss
march	march
lynn	lynn
césar	césar
interrotto	unterbrochen
ufc	ufc
hearts	hearts
dichiarata	deklariert
discorsi	reden
dipendenza	abhängigkeit
bolivia	bolivien
insegnare	lehren
levante	levante
mezzanotte	mitternacht
centenario	hundertjahrfeier
yang	yang
pia	pia
salvataggio	rettung
raggruppamento	gruppierung
rieti	rieti
theory	theory
osso	knochen
chen	chen
pippo	pippo
bristol	bristol
rich	rich
anatomia	anatomie
compressione	kompression
legislativo	legislativen
stampato	gedruckt
conan	conan
beverly	beverly
trecento	trecento
sposta	verschieben
armonia	harmonie
edison	edison
esposte	exponiert
viareggio	viareggio
regular	regular
patty	patty
ain	ain
devozione	hingabe
preparato	vorbereitet
meeting	meeting
parlata	gesprochene
bestia	bestie
tattica	taktik
stimato	geschätzt
gioacchino	gioacchino
ibge	ibge
maine	maine
fermato	gestoppt
spam	spam
possedere	besitzen
circle	circle
pelo	fell
circuiti	schaltungen
eye	eye
contratti	verträge
coupé	coupé
urbanistica	stadtplanung
buffalo	buffalo
pam	pam
lituania	litauen
datazione	datierung
furto	diebstahl
coordinamento	koordinierung
cabina	kabine
bennett	bennett
pensieri	gedanken
circo	zirkus
locomotiva	lokomotive
bush	bush
chelsea	chelsea
progresso	fortschritt
effettivo	tatsächlichen
raoul	raoul
osservato	beobachtet
anders	anders
privilegi	privilegien
ducati	ducati
chip	chip
village	village
reid	reid
proiezione	projektion
impedisce	verhindert
persia	persien
presunto	angeblichen
pelliccia	pelz
osaka	osaka
through	through
legioni	legionen
pinna	flosse
modesto	bescheiden
bart	bart
omar	omar
cron	cron
compton	compton
estonia	estland
determinati	bestimmte
muhammad	muhammad
bowie	bowie
viktor	viktor
cave	cave
tiziano	tiziano
logan	logan
necropoli	nekropole
danneggiato	beschädigt
passarono	vergingen
nigeria	nigeria
valentina	valentina
esatto	genau
oklahoma	oklahoma
magazzino	lager
tramonto	sonnenuntergang
benz	benz
reputazione	reputation
reputazione	ruf
zagabria	zagreb
malesia	malaysia
monasteri	klöster
rebecca	rebecca
wwf	wwf
vancouver	vancouver
hannover	hannover
itunes	itunes
etnie	ethnien
missouri	missouri
denuncia	beschwerde
lusso	luxus
eccezioni	ausnahmen
ragni	spinnen
garda	garda
zeus	zeus
rappresentava	vertrat
forever	forever
strange	strange
hardware	hardware
murder	murder
spoleto	spoleto
pazzo	verrückt
rana	frosch
tonalità	farbton
rico	rico
foglia	blatt
insegnato	lehrte
work	work
itf	itf
neutrale	neutral
laboratori	laboratorien
guai	ärger
virtus	virtus
catholic	catholic
insulti	beleidigungen
agata	agata
self	self
marty	marty
radicali	radikale
genetica	genetik
nicchia	nische
triangolare	dreieckigen
accoglienza	empfang
gesuiti	jesuiten
kings	kings
abbreviato	verkürzt
procura	vollmacht
combattuto	gekämpft
contrasti	kontraste
scenario	szenario
underground	untergrund
connor	connor
catalano	katalanisch
scarico	entlastung
ranger	ranger
technology	technology
separa	trennt
terni	terni
tensioni	spannungen
miglio	meile
muscoli	muskeln
isolato	isoliert
determinate	bestimmte
trasmettere	übermitteln
petra	petra
piscina	schwimmbad
lezione	lektion
basilicata	basilikata
wimbledon	wimbledon
inventato	erfunden
eccessivo	übermäßigen
mediamente	durchschnittlich
pian	pian
torretta	aufsatz
controlli	kontrollen
lennon	lennon
stampe	drucke
galileo	galileo
antiochia	antiochia
capolavoro	meisterwerk
pretty	pretty
alone	alone
indagare	untersuchen
room	room
suzuki	suzuki
global	global
renania	rheinland
oreste	oreste
ennio	ennio
certificato	zertifikat
virgin	virgin
serale	abendliche
avanzato	fortgeschrittenen
paula	paula
bellini	bellini
ricorrente	klägerin
fenice	fenice
visitato	besucht
jose	jose
satelliti	satelliten
walk	walk
montréal	montréal
carrello	warenkorb
forno	ofen
gerald	gerald
consensuale	einvernehmlich
designato	benannten
rodano	rhône
brooke	brooke
sapeva	wusste
islandese	isländischen
epoche	epochen
beethoven	beethoven
avvisato	gewarnt
alabama	alabama
xxiii	xxiii
innovazione	innovation
afc	afc
brandeburgo	brandenburg
mister	mister
hardy	hardy
danubio	donau
morrison	morrison
indian	indian
joyce	joyce
tasse	steuern
orizzonte	horizont
curve	kurven
significati	bedeutungen
pascal	pascal
porter	porter
potenzialmente	potentiell
tennessee	tennessee
frequenze	frequenzen
notre	notre
dorato	goldenen
choice	choice
antagonista	antagonist
plus	plus
julius	julius
moldavia	moldawien
poli	poli
cristalli	kristalle
ellen	ellen
eccellente	ausgezeichnet
mccartney	mccartney
jin	jin
holstein	holstein
provvisorio	vorläufigen
dts	dts
salisburgo	salzburg
richardson	richardson
heavyweight	heavyweight
lance	lance
papi	papi
prezioso	wertvoll
valuta	währung
budget	budget
schumacher	schumacher
atlético	atlético
armonica	mundharmonika
autobiografia	autobiografie
dreams	dreams
htm	ppa
htm	htm
socialisti	sozialisten
casalinga	hausfrau
derivare	ableiten
vigilia	vorabend
chiarire	klären
repressione	unterdrückung
champagne	champagner
elementari	elementaren
inganno	täuschung
macchie	flecken
lungometraggio	spielfilm
teorico	theoretischen
investimenti	investitionen
paesaggi	landschaften
weber	weber
tina	tina
boom	boom
janet	janet
dresda	dresden
pratico	praktische
allegro	fröhlich
schierato	entfaltet
louvre	louvre
huber	huber
strategico	strategisch
strategico	strategische
natural	natural
bei	eib
pacchetto	paket
ascoltare	zuhören
emozioni	emotionen
corpus	corpus
prevalenza	prävalenz
mercoledì	mittwoch
vacanze	urlaub
palo	stange
ginnasta	turnerin
crawford	crawford
luminosità	helligkeit
sebastián	sebastián
percezione	wahrnehmung
omosessualità	homosexualität
spirit	spirit
mercury	mercury
cache	zwischenspeicher
triste	traurig
intelligence	intelligence
ncaa	ncaa
espone	legt
piave	piave
preside	schulleiter
aircraft	aircraft
etnica	ethnischen
raf	raf
portali	portale
manfredi	manfredi
vico	vico
nervoso	nervös
identico	identisch
race	race
pazienza	geduld
chase	chase
nico	nico
born	born
sporting	sporting
muscolo	muskel
caricato	hochgeladen
convenzioni	konventionen
gomma	gummi
ideologia	ideologie
plurale	plural
britannia	britannia
crazy	crazy
gottfried	gottfried
kenya	kenia
jet	jet
epidemia	epidemie
maratona	marathon
burke	burke
motta	motta
entusiasmo	begeisterung
infezione	infektion
novella	novella
demolizione	abriss
demolizione	abbruch
benito	benito
sherman	sherman
posizionato	positioniert
élite	eliten
carlotta	carlotta
pirata	pirat
commedie	komödien
drake	drake
lindsay	lindsay
socialismo	sozialismus
heroes	heroes
schneider	schneider
telescopio	teleskop
zombie	zombie
navarro	navarro
bere	trinken
sintetizzatore	synthesizer
eagle	eagle
uss	uss
nani	zwerge
mad	mad
sally	sally
mobilità	mobilität
umidità	feuchtigkeit
normanni	normannen
once	unzen
fabbri	schmiede
henderson	henderson
prototipi	prototypen
immigrati	einwanderer
validità	gültigkeit
aristotele	aristoteles
rossini	rossini
utah	utah
hulk	hulk
stalin	stalin
sintetico	synthetischen
pene	penis
before	before
valeria	valeria
esercizi	übungen
panini	sandwiches
ammirare	bewundern
dipendenze	abhängigkeiten
ricky	ricky
cartagine	karthago
banchiere	banker
joshua	joshua
manzoni	manzoni
touch	touch
spirale	spirale
prestigioso	renommierten
foglio	blatt
solenne	feierliche
piste	pisten
vietato	verboten
without	without
rispetta	respektiert
cilindro	zylinder
irlandesi	iren
posa	pose
mercenari	söldner
rimanenti	verbleibenden
cugina	cousine
peggiore	schlimmsten
jefferson	jefferson
sopravvissuto	überlebt
antonello	antonello
police	police
efficiente	effizient
delfino	delphin
risorgimento	risorgimento
berna	bern
thing	thing
living	living
cattolicesimo	katholizismus
christine	christine
onu	uno
tiberio	tiberius
illustrazioni	illustrationen
opus	opus
bradley	bradley
germain	germain
indossare	tragen
funghi	pilze
turbo	turbo
scenografia	bühnenbild
direttrice	direktorin
giuramento	eid
boreale	borealen
adolescente	teenager
diacono	diakon
battaglioni	bataillone
diciotto	achtzehn
cavour	cavour
than	than
erich	erich
matrimoni	hochzeiten
ingegneri	ingenieure
impossibilità	unmöglichkeit
redattore	redakteur
adda	adda
abolizione	abschaffung
grammatica	grammatik
interruzione	unterbrechung
totò	totò
rue	rue
visconte	viscount
fibra	faser
vaso	vase
evangelista	evangelista
convinzione	überzeugung
allungato	gedehnt
tel	tel
french	french
timore	furcht
zoo	zoo
noah	noah
scadenza	ablauf
berkeley	berkeley
cia	cia
desideri	wünsche
sax	sax
étienne	étienne
fish	fish
lazzaro	lazarus
rituale	ritual
flying	flying
logico	logisch
irregolare	unregelmäßig
condiviso	geteilt
vena	vene
voivodato	woiwodschaft
middle	middle
legislazione	rechtsvorschriften
acuto	akuten
ride	ride
sceneggiatrice	drehbuchautorin
sensazione	gefühl
federica	federica
islamico	islamischen
legittimo	legitim
calabrese	calabrese
transetto	querschiff
interi	ganze
farnese	farnese
agrigento	agrigent
cecoslovacchia	tschechoslowakei
macedone	mazedonische
farfalla	schmetterling
crash	absturz
esercitare	ausüben
somministrazione	verabreichung
cessione	veräußerung
eugene	eugene
serbatoio	tank
ammasso	lagerhaltung
platone	plato
teen	jugendlich
domingo	domingo
custodia	gewahrsam
miscela	mischung
paz	paz
geologica	geologische
cetra	zither
lions	lions
train	train
genovesi	genuesen
pittrice	malerin
tropicale	tropischen
indianapolis	indianapolis
richmond	richmond
paradise	paradise
monroe	monroe
fly	fly
triple	triple
controversie	streitigkeiten
impegni	verpflichtungen
shin	shin
dalmazia	dalmatien
bailey	bailey
romolo	romolo
fabbriche	fabriken
follia	wahnsinn
donatello	donatello
anita	anita
mosè	moses
giudicare	beurteilen
mole	mole
problematico	problematisch
strasburgo	straßburg
finalità	zweck
agostini	agostini
correlati	verwandte
abitudine	gewohnheit
riscaldamento	heizung
iowa	iowa
peace	peace
amare	lieben
custode	hüterin
enrique	enrique
francescano	franziskaner
buddha	buddha
sudan	sudan
aperture	öffnungen
sostenitore	verfechter
fissato	festgesetzt
tripoli	tripolis
figc	figc
contenitore	behälter
mosaico	mosaik
samantha	samantha
gerardo	gerardo
ireland	ireland
sodio	natrium
pugliese	pugliese
casuale	zufällige
fascisti	faschisten
ottavio	ottavio
société	société
notti	nächte
rubare	stehlen
fbi	fbi
connazionale	landsmann
sharon	sharon
balletto	ballett
magna	magna
prevenire	vorbeugen
bestiame	vieh
risveglio	erwachen
editor	editor
bass	bass
corridoio	flur
paraguay	paraguay
rica	rica
funerale	beerdigung
willie	willie
mon	mon
bandiere	fahnen
athletic	athletic
ciro	ciro
strutturale	strukturelle
tram	straßenbahn
approfondire	vertiefen
macerata	macerata
dinosauri	dinosaurier
hopkins	hopkins
imola	imola
raúl	raúl
africani	afrikaner
fight	fight
elica	propeller
richards	richards
celebra	feiert
botte	fass
borromeo	borromeo
comitati	ausschüsse
warwick	warwick
galassie	galaxien
difetti	mängel
symphony	symphony
tendenze	trends
tendenze	tendenzen
campus	campus
degno	würdig
alive	alive
prevenzione	prävention
perfect	perfect
superiorità	überlegenheit
coincide	zusammenfällt
risonanza	mrt
somiglianza	ähnlichkeit
capitali	hauptstädte
moschea	moschee
solidarietà	solidarität
concept	concept
inside	inside
veronese	veronese
feudale	feudalen
perfezione	perfektion
moti	moti
grimaldi	grimaldi
nhl	nhl
melodia	melodie
giornalismo	journalismus
coinvolta	beteiligt
acidi	säuren
miele	honig
cime	zinnen
avanzare	unterbreiten
ritrovare	wiederfinden
duecento	zweihundert
nothing	nothing
pierce	pierce
osservatori	beobachter
mclaren	mclaren
ovvio	offensichtlich
maledizione	fluch
protettore	beschützer
midnight	midnight
floyd	floyd
metropolitan	metropolitan
mostrò	zeigte
mali	mali
sperimentazione	erprobung
appendice	anlage
tracy	tracy
filtro	filter
raffreddamento	kühlung
iucn	iucn
hewitt	hewitt
sagra	kirmes
mhz	mhz
creta	kreta
around	around
direzioni	richtungen
formaggio	käse
conservatore	konservativ
rinnovato	erneuert
jakob	jakob
ultra	ultra
dipartimenti	departements
mouse	maus
povera	arme
catalogna	katalonien
drew	drew
arnoldo	arnoldo
arnaldo	arnaldo
lotus	lotus
raffigurato	abgebildet
dimostrano	belegen
sankt	sankt
dominique	dominique
solitario	einsam
contingente	kontingent
cicli	zyklen
leggendario	legendären
rodrigo	rodrigo
spring	spring
antenati	vorfahren
riviera	riviera
batteri	bakterien
biologico	biologischen
snow	snow
istituzionale	institutionellen
confluenza	zusammenfluss
alexandra	alexandra
raccontare	erzählen
fulvio	fulvio
houten	houten
sts	sts
why	why
yves	yves
pianificazione	planung
moreno	moreno
lynch	lynch
brand	brand
vanessa	vanessa
sabina	sabina
miglioramenti	verbesserungen
official	official
esposizioni	ausstellungen
giungla	dschungel
genealogia	genealogie
astronauta	astronaut
ammissione	zulassung
filosofico	philosophische
patrizia	patrizia
xls	xls
pascoli	weiden
buco	loch
kai	kai
indispensabile	unentbehrlich
indispensabile	unerlässlich
piceno	piceno
persiani	perser
raid	raid
kathy	kathy
prati	wiesen
asiatici	asiaten
sciopero	streik
accelerazione	beschleunigung
consacrazione	weihe
ferruccio	ferruccio
dito	finger
unit	unit
lex	lex
conrad	conrad
martha	martha
attivazione	aktivierung
pinne	flossen
has	has
benvenuto	willkommen
geni	gene
presidenziali	präsidentschaftswahlen
continuazione	fortsetzung
atalanta	atalanta
combustione	verbrennung
dmitrij	dmitri
misericordia	barmherzigkeit
goes	goes
crono	kronos
garanzia	garantie
bassano	bassano
molise	molise
abitudini	gewohnheiten
discusso	diskutiert
bastone	stock
nassau	nassau
small	small
caraibi	karibik
davies	davies
speed	speed
cpu	cpu
silent	silent
postumo	postumus
dama	dame
suárez	suárez
rush	rush
gode	genießt
herman	herman
paragrafi	absätze
appunti	zwischenablage
pranzo	mittagessen
jill	jill
dakota	dakota
sarda	sarda
beyond	beyond
tecnicamente	technisch
angelis	angelis
vassallo	vasall
dimenticare	vergessen
protestanti	protestanten
oregon	oregon
schleswig	schleswig
istante	sofortige
ramón	ramón
reggenza	regentschaft
inquinamento	umweltverschmutzung
mattia	mattia
iniezione	injektion
capra	ziege
petr	petr
capitani	kapitäne
compatibile	kompatibel
veleno	gift
mans	mans
christie	christie
adriana	adriana
rey	rey
duemila	zweitausend
prestato	geliehen
siro	siro
trascrizione	transkription
senatori	senatoren
louisiana	louisiana
nilo	nil
istria	istrien
crotone	crotone
nebbia	nebel
trevor	trevor
prospetto	prospekt
razzo	rakete
lesioni	verletzungen
banks	banks
erzegovina	herzegowina
rinaldo	rinaldo
pattinaggio	eislaufen
elfi	elfen
preliminari	vorspiel
billie	billie
confuso	verwirrt
panico	panik
ioni	ionen
mick	mick
accettabile	akzeptabel
accettabile	annehmbar
penna	stift
pordenone	pordenone
guatemala	guatemala
rubato	gestohlen
curia	curia
sedia	stuhl
things	things
approssimativamente	ungefähr
cameo	cameo
criticato	kritisiert
guardiano	wächter
nevada	nevada
complice	komplize
repubblicani	republikaner
rocky	rocky
belluno	belluno
mcdonald	mcdonald
comporre	komponieren
incapace	unfähig
preferenze	präferenzen
wii	wii
nielsen	nielsen
twilight	twilight
wing	wing
sosteneva	argumentierte
geologo	geologe
travis	travis
aspetta	warte
lily	lily
strauss	strauss
vittore	vittore
sora	sora
essenza	wesen
griffin	griffin
rome	rome
para	para
sottogruppo	untergruppe
low	low
temple	temple
documentari	dokumentarfilme
karate	karate
andre	andre
baritono	bariton
consapevolezza	bewusstsein
julio	julio
burns	burns
sintassi	syntax
jun	jun
credeva	glaubte
pratt	pratt
robbie	robbie
emissioni	emissionen
api	api
residenziale	wohn
fondista	langstreckenläufer
sega	säge
proporzionale	proportional
scappa	lauf
álvarez	álvarez
disponeva	verfügte
june	june
marija	marija
remo	remo
mitragliatrice	maschinengewehr
maxwell	maxwell
eterno	ewige
gone	gone
stress	stress
abbreviazione	abkürzung
reati	straftaten
confessione	geständnis
curioso	neugierig
convogli	konvois
ceneri	asche
hansen	hansen
considerevole	beträchtliche
piramide	pyramide
collinare	hügelland
ace	ace
gérard	gérard
montreal	montreal
arno	arno
freedom	freedom
quarterback	quarterback
matera	matera
dubbia	zweifelhafter
bandito	bandit
wife	wife
pearl	pearl
agg	agg
turn	turn
crime	crime
pallamano	handball
solomon	solomon
number	number
santoro	santoro
benessere	wohlbefinden
pugilato	boxen
avorio	elfenbein
morning	morning
manovre	manöver
spettatore	zuschauer
baldini	baldini
evidenziato	hervorgehoben
programmato	programmiert
ripetizione	wiederholung
pronti	bereit
hitchcock	hitchcock
quinn	quinn
target	target
avanzate	erweitert
jam	jam
arteria	arterie
sociologia	soziologie
erezione	erektion
asilo	asyl
semplicità	einfachheit
stephanie	stephanie
rendimento	rendite
heat	heat
leghe	legierungen
direttori	direktoren
detenuto	häftling
milton	milton
schiavo	sklave
thriller	thriller
castelnuovo	castelnuovo
pastori	hirten
mah	mah
retto	rektum
crystal	crystal
fantasmi	geister
serenissima	serenissima
documentato	dokumentiert
annunciazione	verkündigung
sinodo	synode
gate	gate
ambasciata	botschaft
levy	levy
range	range
politicamente	politisch
newman	newman
portland	portland
shock	schock
agnese	agnes
hour	hour
samurai	samurai
eterna	ewige
woody	woody
casey	casey
kids	kids
novo	novo
silvestro	silvestro
borghesia	bourgeoisie
etimologia	etymologie
cuori	herzen
wave	wave
finanziamento	finanzierung
segmenti	segmente
development	development
organigramma	organigramm
leggo	lese
assorbimento	resorption
artico	arktis
praticato	praktiziert
praticato	praktizierte
limited	limited
stéphane	stéphane
diffondere	verbreiten
ristampato	nachgedruckt
joachim	joachim
affinità	affinität
tirinto	tiryns
aeroporti	flughäfen
lionel	lionel
republic	republic
pescatori	fischer
solitudine	einsamkeit
offensivo	beleidigend
ottaviano	oktavian
adorazione	anbetung
cry	cry
voice	voice
oracolo	orakel
puccini	puccini
decadenza	verfall
auguste	auguste
scarpe	schuhe
replica	replica
triennale	dreijährigen
jiří	jiří
mickey	mickey
homer	homer
tomas	tomas
cognato	schwager
thor	thor
promo	promo
shawn	shawn
ulisse	odysseus
calais	calais
canyon	canyon
ángel	ángel
barbarossa	barbarossa
olivia	olivia
biella	biella
biologo	biologe
egidio	egidio
melissa	melissa
sottomissione	unterwerfung
terrorismo	terrorismus
amelia	amelia
cincinnati	cincinnati
emerson	emerson
publio	publius
jeffrey	jeffrey
colto	gelesen
mcenroe	mcenroe
johansson	johansson
antonella	antonella
estinto	ausgestorben
narratore	erzähler
council	council
churchill	churchill
branca	branca
nastri	bänder
ghiacciaio	gletscher
comes	comes
alberti	alberti
dittatura	diktatur
realismo	realismus
beth	beth
jeanne	jeanne
cascina	cascina
angola	angola
freni	bremsen
accessori	zubehör
luc	luc
sabrina	sabrina
clinton	clinton
troll	troll
ontario	ontario
canadian	canadian
need	need
convertito	umgewandelt
vega	vega
biglietto	ticket
abbondanza	überfluss
accoglie	begrüßt
precede	vorausgeht
rapimento	entführung
brevetto	patent
squadrone	geschwader
pomerania	pommern
addetti	beschäftigten
tours	tours
breda	breda
fury	fury
palcoscenico	bühne
tabelle	tabellen
obiezioni	einwände
dale	dale
infantile	kindisch
anarchico	anarchist
visioni	visionen
cosmo	cosmo
mazza	schläger
empoli	empoli
oswald	oswald
spike	spike
esplodere	explodieren
asteroidi	asteroiden
ego	ego
theodore	theodore
ferrer	ferrer
ferrero	ferrero
emil	emil
key	key
eppure	doch
government	government
parlava	sprach
species	species
clay	clay
milizia	miliz
fiba	fiba
reggimenti	regimenter
impronta	abdruck
invasioni	invasionen
liu	liu
irving	irving
omosessuali	homosexuellen
plinio	plinius
nuvole	wolken
etichette	etiketten
drop	drop
previsione	vorhersage
nettuno	neptun
segunda	segunda
give	give
camion	lkw
airways	airways
telecomunicazioni	telekommunikation
espulsione	ausweisung
curatore	kurator
rhodes	rhodes
quaderni	hefte
norimberga	nürnberg
primitivo	primitiv
spiagge	strände
salomone	salomo
independent	independent
loreto	loreto
eliminando	indem
client	client
quercia	eiche
glory	glory
algebra	algebra
lena	lena
had	had
avvocati	rechtsanwälte
penny	penny
sampdoria	sampdoria
segretamente	heimlich
apocalisse	apokalypse
tranquillo	ruhig
siluri	torpedos
segnala	meldet
trail	trail
upon	upon
andrews	andrews
scherzo	witz
petit	petit
galaxy	galaxy
blair	blair
shot	shot
pellegrinaggio	pilgerfahrt
flight	flight
bellinzona	bellinzona
borgia	borgia
immigrazione	einwanderung
pepe	pfeffer
ripetere	wiederholen
piazze	plätze
coma	koma
cotton	cotton
ballata	ballade
cornelio	cornelius
berry	berry
bellissima	wunderschön
clarinetto	klarinette
fili	fäden
dittatore	diktator
african	african
shane	shane
eden	eden
jensen	jensen
romance	romance
kirk	kirk
riflessi	reflexe
food	food
gcatholic	gcatholic
ammette	räumt
basilio	basilio
kerry	kerry
running	running
weekend	wochenende
its	its
sandbox	sandbox
capsula	kapsel
violenti	gewalttätigen
diamanti	diamanten
pagato	bezahlte
pagato	bezahlt
susa	susa
obbligatorio	obligatorisch
rovigo	rovigo
elliott	elliott
innovazioni	innovationen
plasma	plasma
trombone	posaune
joy	joy
improvvisa	plötzliche
inclinazione	neigung
andersen	andersen
alexis	alexis
fegato	leber
annullato	abgesagt
canonica	pfarrhaus
sociologo	soziologe
ironia	ironie
felipe	felipe
quo	quo
yamaha	yamaha
lacrime	tränen
acquedotto	aquädukt
hammond	hammond
adeguato	angemessen
adeguato	angemessene
sailor	sailor
psi	psi
equatore	äquator
amour	amour
rapina	überfall
against	against
marconi	marconi
patriarcato	patriarchat
nadia	nadia
barletta	barletta
attentati	anschläge
anglosassone	angelsächsischen
nuotatrice	schwimmerin
aquino	aquino
triplo	dreifache
triplo	dreifach
norton	norton
siberia	sibirien
quantistica	quanten
falsi	gefälschte
sinagoga	synagoge
fondamento	grundlage
giulietta	julia
mela	apfel
