del	del
che	que
per	para
score	score
con	con
una	una
non	no
dell	dell
come	cómo
come	como
sono	soy
sono	son
più	más
anche	también
anche	incluso
team	team
seed	seed
gli	los
all	all
due	dos
tra	entre
era	estaba
era	era
dopo	después
prima	primera
prima	antes
prima	primero
parte	parte
stato	estado
altri	otros
bar	bar
cest	cest
anni	años
italiano	italiano
essere	ser
questo	este
questo	esto
esterni	externos
esterni	exteriores
collegamenti	enlaces
collegamenti	acoplamientos
collegamenti	conexiones
nell	nell
serie	serie
serie	series
viene	viene
text	text
cet	cet
questa	esta
film	películas
film	película
regia	regia
città	ciudades
città	ciudad
solo	solo
solo	sólo
uno	uno
loro	ellos
primo	primera
primo	primer
primo	primero
nome	nombre
san	san
poi	luego
secondo	segundo
msg	msg
voce	voz
progetti	proyectos
sia	sea
sia	tanto
dove	donde
dove	dónde
quando	cuándo
quando	cuando
anno	año
durante	durante
voci	rumores
voci	voces
italia	italia
fino	hasta
quale	cual
quale	cuál
tre	tres
molto	muy
molto	mucho
from	from
può	puede
hanno	tienen
comune	común
comune	frecuentes
stesso	mismo
tutti	todos
stagione	temporada
gruppo	grupo
stati	estados
contro	contra
dai	dai
calciatore	futbolista
roma	roma
così	así
tempo	tiempo
abitanti	habitantes
till	till
chiesa	iglesia
grande	grande
grande	gran
secolo	siglo
guerra	guerra
sempre	siempre
fatto	hecho
volta	vez
fontsize	fontsize
erano	eran
erano	estaban
storia	historia
quella	esa
fine	fin
seguito	seguido
aveva	tenía
quello	ese
quello	eso
album	álbum
album	album
album	álbumes
già	ya
altre	otras
alcuni	algunos
ancora	todavía
ancora	aún
senza	sin
francese	francés
seconda	segunda
finale	final
vita	vida
titolo	título
shift	shift
campionato	campeonato
ogni	cada
mondo	mundo
furono	fueron
tutto	todo
settembre	septiembre
nazionale	nacional
italiana	italiana
circa	aproximadamente
circa	sobre
quanto	cuanto
quanto	cuánto
altro	otro
sotto	debajo
wikipedia	wikipedia
calcio	fútbol
calcio	futbol
famiglia	familia
inoltre	además
quali	cuáles
quali	cuales
numero	número
milano	milán
via	vía
proprio	propio
ottobre	octubre
maggio	mayo
ruolo	rol
gennaio	enero
modo	manera
modo	modo
nuovo	nuevo
perché	porque
casa	casa
generale	general
marzo	marzo
squadra	equipo
dicembre	diciembre
caso	caso
sue	sue
giugno	junio
questi	estos
questi	éstos
agosto	agosto
luglio	julio
politico	político
opera	opera
opera	ópera
fra	entre
verso	hacia
aprile	abril
pagina	página
periodo	periodo
periodo	período
novembre	noviembre
giovanni	juan
grazie	gracias
insieme	conjunto
insieme	juntos
insieme	juntas
lui	él
morte	muerte
maria	maría
nuova	nueva
febbraio	febrero
john	john
centro	centro
inglese	inglés
inglese	ingles
quattro	cuatro
interno	interior
interno	interna
interno	interno
attività	actividad
attività	actividades
alcune	algunas
tutte	todas
causa	causa
edizione	edición
qui	aquí
nord	norte
diretto	directo
diretto	directa
esempio	ejemplo
ultimo	último
ultimo	última
sfondo	fondo
versione	versión
provincia	provincia
attore	actor
tale	tal
coppa	copa
forma	forma
codice	codigo
codice	código
oggi	hoy
base	base
trova	encuentra
poco	poco
punto	punto
figlio	hijo
corso	curso
corso	corso
allenatore	entrenador
molti	muchos
particolare	particular
sistema	sistema
società	sociedad
tipo	tipo
maggiore	mayor
club	club
regione	región
sud	sur
discussione	debate
discussione	discusión
padre	padre
linea	línea
santa	santa
sede	sede
pubblicato	publicado
carlo	carlo
carlo	carlos
progetto	proyecto
primi	primeros
possono	pueden
mai	nunca
lungo	largo
uso	uso
value	value
tedesco	alemán
tedesco	aleman
grado	grado
uniti	unidos
lavoro	trabajo
isbn	isbn
fare	hacer
giorno	día
principale	principal
termine	término
termine	plazo
mondiale	mundial
regno	reino
ben	ben
specie	especie
specie	especies
persone	gente
persone	personas
pagine	páginas
pagine	paginas
volte	veces
set	set
inizio	inicio
inizio	comienzo
jpg	jpg
vengono	vienen
sarebbe	sería
episodio	episodio
rispetto	respeto
francesco	francisco
posizione	posición
posizione	ubicación
genere	género
turno	turno
queste	estas
presidente	presidente
stessa	misma
cosa	qué
militare	militar
uomo	hombre
meno	menos
campo	campo
giorni	días
carriera	carrera
scritto	escrito
ora	ahora
territorio	territorio
gen	gen
antonio	antonio
giuseppe	josé
diversi	varios
diversi	diferentes
quasi	casi
data	fecha
data	data
altra	otra
terra	tierra
presente	presente
allora	entonces
successo	éxito
opere	obras
ordine	orden
ordine	pedido
categoria	categoría
epoca	época
produzione	producción
strada	calle
strada	carretera
corpo	cuerpo
quest	quest
scrittore	escritor
lug	jul
ultima	última
cura	cura
francia	francia
lingua	lengua
lingua	idioma
zona	zona
livello	nivel
battaglia	batalla
premio	premio
attrice	actriz
ott	ott
ott	oct
disciplina	disciplina
momento	momento
mag	mag
studio	studio
oro	oro
singolo	único
singolo	individuales
paese	país
successivamente	posteriormente
width	width
cantante	cantante
arte	arte
età	edad
storico	histórico
storico	historiador
vescovo	obispo
york	york
squadre	equipos
precedente	anterior
area	area
area	área
episodi	episodios
chi	quiénes
chi	quién
paolo	pablo
possibile	posible
nov	nov
avere	tener
servizio	servicio
regista	cineasta
punti	puntos
repubblica	república
governo	gobierno
dato	dado
originale	original
apr	abr
grandi	grandes
palazzo	palacio
giocatore	jugador
università	universidades
università	universidad
isola	isla
quelle	esas
far	far
capo	jefe
musica	música
divisione	división
luogo	lugar
ago	ago
ago	aguja
dic	dic
iii	iii
napoli	nápoles
ebbe	tuvo
parigi	paris
parigi	parís
sembra	parece
gioco	juego
terzo	tercer
terzo	tercero
feb	feb
ufficiale	oficial
luigi	luis
luigi	luigi
vittoria	triunfo
vittoria	victoria
centrale	central
internazionale	internacional
porta	puerta
sei	seis
sei	eres
presenti	presentes
partire	partir
popolazione	población
america	américa
piano	plan
origine	origen
prodotto	producto
presenza	presencia
libro	libro
scuola	escuela
immagine	imagen
esercito	ejército
deve	debe
autore	autor
classifica	clasifica
classifica	ranking
personaggio	personaje
importante	importante
torneo	torneo
europa	europa
situato	situado
propria	propia
quelli	ésos
quelli	aquellos
firenze	florencia
comunità	comunidades
comunità	comunidad
giovane	joven
madre	madre
stazione	estación
avrebbe	tendría
presenta	presenta
vari	varios
pietro	pedro
studi	estudios
fonte	fuente
acqua	agua
torino	turín
cinque	cinco
basso	bajo
partito	partido
unità	unidades
unità	unidad
fonti	fuentes
politica	política
lei	ella
lei	usted
metà	mitad
metri	metros
alto	alto
tratta	trata
top	top
vennero	vinieron
testo	texto
align	align
usa	usa
tour	tour
tour	tours
dati	datos
tutta	toda
teatro	teatro
procedura	procedimiento
cardinale	cardenal
cardinale	cardinal
unico	único
papa	papa
uomini	hombres
visto	visado
visto	visa
visto	visto
ricerca	busqueda
ricerca	investigación
ricerca	búsqueda
ricerca	buscar
principali	principales
massimo	máximo
massimo	massimo
stile	estilo
left	left
germania	alemania
donna	mujer
superficie	superficie
alta	alta
castello	castillo
distretto	distrito
nota	nota
mesi	meses
moglie	esposa
successivo	siguiente
tanto	tanto
ritorno	retorno
ritorno	regreso
ritorno	vuelta
costruzione	construcción
subito	enseguida
totale	total
canzone	canción
vista	vista
detto	dicho
attuale	actual
avuto	tenido
note	notas
varie	varios
varie	varias
altezza	altura
chitarra	guitarra
robert	robert
fiume	río
musicale	musical
figlia	hija
realtà	realidades
realtà	realidad
fuori	fuera
fuori	afuera
for	for
monte	monte
contea	condado
museo	museo
forse	quizás
forse	quizá
protagonista	protagonista
legge	ley
mario	mario
molte	muchas
stadio	estadio
fase	fase
classe	clase
amore	amor
michael	michael
fratello	hermano
sviluppo	desarrollo
prime	prime
prime	primeras
pittore	pintor
sarà	será
comuni	comunes
comuni	comunas
pubblico	público
pubblico	públicos
venezia	venecia
infine	finalmente
media	media
media	promedio
struttura	estructura
gray	gray
paesi	paises
paesi	países
personaggi	personajes
londra	londres
formazione	formación
marco	marco
marco	marcos
world	world
you	you
probabilmente	probablemente
bene	bien
britannico	británico
romano	romano
informazioni	información
utente	usuario
italiani	italianos
locale	local
james	james
video	vídeo
video	vídeos
video	video
video	videos
giochi	juegos
disco	disco
conte	conde
conte	conte
giapponese	japonesa
giapponese	japonés
direttore	director
direttore	gerente
direttore	directora
peso	peso
figli	hijos
avevano	tenían
piccolo	pequeño
campionati	campeonatos
unica	única
importanti	importantes
cestista	baloncestista
von	von
terza	tercera
occasione	ocasión
programma	programa
sta	está
barra	barra
nominato	nombrado
noto	noto
testa	cabeza
romanzo	novela
potrebbe	podría
jean	jean
forte	fuerte
forze	fuerzas
numerosi	numerosos
william	william
impero	imperio
diritto	derecho
start	start
nazionali	nacionales
mare	mar
unione	unión
star	star
piazza	plaza
george	george
potere	poder
rgb	rgb
presenze	presencias
senso	sentido
rete	red
lato	lado
forza	fuerza
superiore	superior
breve	corto
breve	breve
lavori	trabajos
spagnolo	español
van	van
fronte	frente
ovest	oeste
andrea	andrea
andrea	andrés
nato	nacido
nato	otan
dipartimento	departamento
controllo	control
winner	winner
saint	saint
increment	increment
don	don
passato	pasado
caratteristiche	características
edizioni	ediciones
dire	decir
guida	guía
guida	guia
diocesi	diócesis
gridcolor	gridcolor
consiglio	consejo
villa	villa
lightgrey	lightgrey
mappa	mapa
membri	miembros
giorgio	jorge
problemi	problemas
antica	antigua
darkgrey	darkgrey
problema	problema
milioni	millones
mano	mano
chiamato	llamado
migliore	mejor
pochi	pocos
parti	partes
giornalista	reportero
giornalista	periodista
mio	mío
mio	mi
festival	festival
civile	civil
evoluzione	evolución
valle	valle
luce	luz
compositore	compositor
sezione	sección
ultimi	últimos
ultimi	ultimos
attualmente	actualmente
ore	horas
peter	peter
dio	dios
casi	casos
inizia	empieza
inizia	comienza
sinistra	izquierda
modello	plantilla
modello	modelo
istituto	instituto
aeroporto	aeropuerto
velocità	velocidad
imperatore	emperador
movimento	movimiento
motore	motor
femminile	femenino
vero	cierto
vero	verdad
vero	verdadero
piccola	pequeña
nuovi	nuevos
style	style
valore	valor
gruppi	grupos
bologna	boloña
bologna	bolonia
inizialmente	inicialmente
love	love
cultura	cultura
spazio	espacio
troppo	demasiado
alessandro	alejandro
amico	amigo
membro	miembro
rock	rock
formato	formato
mezzo	medio
lunghezza	eslora
lunghezza	longitud
essendo	siendo
situata	situada
processo	proceso
attacco	ataque
proprietà	propiedades
proprietà	propiedad
interpretato	interpretado
spagna	españa
morì	murió
titoli	títulos
http	http
colore	color
vicino	cerca
orientale	oriental
antico	antiguo
località	localidad
man	man
principe	principe
principe	príncipe
notte	noche
dice	dice
mese	mes
des	des
nuove	nuevas
cancellazione	cancelaciones
cancellazione	borrado
cancellazione	cancelación
batteria	batería
immagini	imagenes
immagini	imágenes
argento	plata
poeta	poeta
tempi	tiempos
persona	persona
charles	charles
rosso	rojo
rosso	roja
russo	ruso
occidentale	occidental
comando	mando
comando	comando
bianco	blanco
appena	apenas
licenza	licencia
reti	redes
funzione	función
numerose	numerosas
scena	escena
richard	richard
cinema	cine
cinema	cines
associazione	asociación
mia	mia
mia	mía
riferimento	referencia
simile	similar
ragazza	chica
ragazza	muchacha
utenti	usuarios
elementi	elementos
franco	franco
costa	costa
entrambi	ambos
arcivescovo	arzobispo
enrico	enrique
torre	torre
reale	real
vol	vol
corte	tribunal
compagnia	compañía
der	der
produttore	productor
produttore	fabricante
azione	acción
risultati	resultados
interesse	interés
aggiornato	actualizado
campione	campeón
campione	muestra
live	live
donne	mujeres
decide	decide
parla	habla
truppe	tropas
possibilità	posibilidades
possibilità	posibilidad
lunga	larga
nero	negro
roberto	roberto
destra	derecha
difesa	defensa
americano	americano
americano	estadounidense
accordo	acuerdo
personale	personal
dimensioni	dimensiones
dimensioni	tamaños
completamente	totalmente
completamente	completamente
seguenti	siguientes
radio	radio
records	records
sette	siete
capitale	capital
martin	martin
competizioni	competiciones
situazione	situación
cancellata	borrada
parole	palabras
aiuto	ayuda
genova	génova
effetti	efectos
greco	griego
scopo	propósito
considerato	considerado
idea	idea
madonna	madonna
rivista	revista
santo	santo
tedesca	alemana
intorno	alrededor
parco	parque
abbia	tenga
resto	resto
romana	romana
incontro	encuentro
otto	ocho
otto	otto
marina	marina
richiesta	petición
richiesta	solicitud
alberto	alberto
editore	editor
risultato	resultado
usato	usado
usato	utilizado
mostra	mostrar
inghilterra	inglaterra
duca	duque
carica	cargar
carica	carga
votazione	votación
sociale	social
maschile	masculina
maschile	masculino
cose	cosas
trovano	encuentran
prova	prueba
prova	ensayo
qualità	calidad
wiki	wiki
rapporto	informe
black	black
minuti	minutos
stella	estrella
stella	stella
porto	puerto
angelo	angelo
angelo	angel
angelo	ángel
center	center
tecnica	técnica
lega	liga
lega	aleación
speciale	especial
azienda	empresa
artista	artista
pure	puras
pure	pure
anna	ana
anna	anna
record	record
record	récord
mercato	mercado
versioni	versiones
giocatori	jugadores
chiamata	llamada
chiamata	llamado
stagioni	temporadas
sale	sal
libri	libros
tali	tales
border	border
trovare	encontrar
cortometraggio	cortometraje
stefano	esteban
stefano	stefano
natura	naturaleza
tennis	tenis
capacità	capacidad
capacità	capacidades
dare	dar
buona	buena
frazione	fracción
nave	nave
nave	buque
estate	verano
pubblica	pública
pubblica	publica
giappone	japón
volume	volumen
fuoco	fuego
vuole	quiere
differenza	diferencia
gol	gol
gol	goles
composto	compuesto
campagna	campaña
accesso	acceso
organizzazione	organización
link	link
link	enlace
lago	lago
canale	canal
popolare	popular
deceduto	difunto
deceduto	fallecido
fanno	hacen
ufficiali	oficiales
viaggio	viaje
quarto	cuarto
tappa	etapa
inferiore	inferior
ponte	puente
materiale	material
pallacanestro	baloncesto
comprende	incluye
bruno	bruno
fisica	física
pilota	piloto
contiene	contiene
armi	armas
relazione	relación
relazione	informe
oggetto	asunto
oggetto	objeto
eventi	eventos
eventi	acontecimientos
medico	medico
medico	médico
conto	cuento
conto	cuenta
semplice	simple
semplice	sencillo
ministro	ministro
ministro	ministra
sole	sol
rimase	quedó
rimase	permaneció
prodotti	productos
sport	deportes
sport	deporte
direttamente	directamente
grafica	gráfica
grafica	gráficos
appare	aparece
ottenere	conseguir
ottenere	obtener
creare	crear
divisioni	divisiones
isole	islas
colonna	columna
medaglia	medalla
testi	textos
creato	creado
sola	sola
tratto	tramo
vecchio	viejo
bassa	baja
matrimonio	boda
matrimonio	matrimonio
minore	menor
aggiornamento	actualizar
aggiornamento	actualización
onda	ola
onda	onda
aspetto	aspecto
aspetto	apariencia
architetto	arquitecto
precedenti	precedentes
precedenti	anteriores
dovuto	debido
contratto	contrato
filippo	felipe
raccolta	recogida
raccolta	recolección
nascita	nacimiento
mark	mark
naturale	natural
scritta	escrita
coppia	par
coppia	pareja
presto	pronto
scelta	elección
vedere	véase
vedere	ver
federico	federico
realizzato	realizado
promozione	promoción
les	les
articolo	articulo
articolo	artículo
condizioni	condiciones
linee	líneas
locali	locales
futuro	futuro
orchestra	orquesta
right	right
settore	sector
principalmente	principalmente
camera	habitación
decise	decidió
chiusa	cerrada
comandante	comandante
settimana	semana
potenza	potencia
giocato	jugado
esiste	existe
atto	acto
com	com
collaborazione	colaboración
russia	rusia
cappella	capilla
credo	creo
figura	figura
ecc	etc
rai	rai
giovani	jovenes
giovani	jóvenes
croce	cruz
zone	zonas
zone	zone
cattolico	católico
posta	correo
michele	michele
francesi	francesas
francesi	franceses
conosciuto	conocido
art	art
regina	regina
regina	reina
tradizione	tradición
polizia	policía
polizia	policia
migliori	mejores
migliori	mejore
sconfitta	derrota
music	music
pace	paz
questione	cuestión
palermo	palermo
favore	favor
qualcosa	algo
massa	massa
massa	masa
energia	energía
rosa	rosado
rosa	rosa
aria	aria
aria	aire
militari	militares
storici	historiadores
storici	históricos
fondata	fundada
nessuno	nadie
nessuno	ninguno
marito	marido
marito	esposo
diretta	directa
capitano	capitán
piccoli	pequeños
elezioni	elecciones
artisti	artistas
teoria	teoría
distribuzione	distribución
sportivo	deportivo
dieci	diez
dieci	dieci
evento	acontecimiento
evento	evento
raggiungere	alcanzar
internazionali	internacionales
tom	tom
enciclopedia	enciclopedia
joseph	joseph
canzoni	canciones
popolo	pueblo
europeo	europeo
mondiali	mundial
distanza	distancia
portato	traído
pro	pro
pro	pros
max	max
max	máx
qualsiasi	cualquier
africa	áfrica
africa	africa
lingue	idiomas
lingue	lenguas
memoria	memoria
amici	amigos
maestro	maestro
bambino	niño
bambino	bebé
unito	unido
libero	libre
giacomo	jaime
giacomo	jacobo
scrivimi	escríbeme
armata	armada
fratelli	hermanos
vera	vera
standard	estándares
standard	estándar
standard	standard
forme	formas
jack	jack
qualcuno	alguien
svg	svg
smith	smith
scoperto	descubierto
fondazione	fundación
nomi	nombres
importanza	importancia
distribuito	distribuido
festa	fiesta
cattolica	católica
cattolica	cattolica
cuore	corazón
villaggio	pueblo
villaggio	aldea
cerca	busca
scrivere	escribir
buon	buen
partecipanti	participantes
morto	muerto
dietro	detrás
apertura	abertura
apertura	apertura
louis	louis
vittorie	victorias
vittorie	triunfos
chiese	iglesias
ottenne	consiguió
ottenne	obtuvo
galleria	galería
galleria	galeria
veniva	venía
esperienza	experiencia
parola	palabra
verde	verde
vince	vince
vince	gana
sceneggiatore	guionista
contributi	contribuciones
preso	tomado
hai	hai
hai	tienes
bambini	niños
santi	santos
santi	santi
fatti	hechos
luca	lucas
luca	luca
accademia	academia
passa	pasa
facendo	haciendo
servizi	servicios
navi	buques
navi	naves
dedicato	dedicado
partecipato	participado
elenco	lista
formula	fórmula
arrivo	llegada
titolare	titular
latino	latino
latino	latín
sicilia	sicilia
elaborazione	procesamiento
international	international
open	open
lorenzo	lorenzo
letteratura	literatura
libertà	libertad
bronzo	bronce
tecniche	técnicas
continua	continuar
continua	continúa
continua	continua
andare	ir
missione	misión
regionale	regional
regionale	regionales
arriva	llega
arriva	arriva
evitare	evitar
evitare	evite
frank	frank
dovrebbe	debería
composta	compuesta
henry	henry
costruito	construido
intervento	intervención
pietra	roca
pietra	piedra
bandiera	bandera
bandiera	pabellón
proposta	propuesta
national	national
critica	critica
critica	crítica
tecnico	técnico
vittorio	víctor
vittorio	vittorio
vittorio	violeta
foto	foto
foto	fotos
soltanto	solamente
incontri	encuentros
arbitro	árbitro
blocca	bloquea
blocca	bloquear
vedi	vea
vedi	véase
vedi	ves
percorso	recorrido
percorso	ruta
one	one
quartiere	vecindario
quartiere	barrio
cinese	chinos
cinese	chino
svizzera	suiza
luoghi	lugares
blu	azul
nobile	noble
trattato	tratado
american	american
diritti	derechos
eletto	electo
eletto	elegido
soldati	soldados
king	king
federazione	federación
perchè	porqué
off	off
davanti	delante
ragazzo	muchacho
ragazzo	chico
stessi	mismos
ottenuto	obtenido
male	mal
confronti	comparaciones
rossi	rossi
dedicata	dedicada
carattere	carácter
bottom	bottom
monaco	monje
monaco	mónaco
soggetto	sujeto
rappresenta	representa
nomination	nominaciones
nomination	nominación
operazione	operación
ucciso	asesinado
ucciso	matado
sorella	hermana
aree	áreas
aree	zonas
aree	areas
vincitore	ganador
raccoglie	recoge
permette	permite
sicurezza	seguridad
passo	paso
xvi	xvi
biblioteca	biblioteca
brasile	brasil
posti	puestos
sistemi	sistemas
volo	vuelo
web	web
significa	significa
architettura	arquitectura
settentrionale	septentrional
simili	similares
necessario	necesario
difficoltà	dificultad
difficoltà	dificultades
under	under
punteggio	puntaje
punteggio	puntuación
tema	tema
animali	animales
piccole	pequeñas
val	val
olandese	neerlandés
olandese	holandés
musicista	músico
deriva	deriva
caccia	caza
creazione	creación
nasce	nace
poteva	podía
utilizzo	utilización
noi	nosotros
cesare	cesar
cesare	césar
colori	colores
diff	diff
cattedrale	catedral
stampa	impresión
stampa	prensa
stampa	imprimir
mosca	moscú
mosca	mosca
storica	histórica
lettera	letra
lettera	carta
europei	europeos
appartenente	perteneciente
messa	misa
esistono	existen
austria	austria
singolare	singulares
singolare	singular
pos	pos
esemplari	especímenes
insee	insee
voti	votos
height	height
motivi	motivos
motivi	razones
giulio	giulio
pubblicazione	publicación
fatta	hecha
berlino	berlin
berlino	berlín
onore	honor
super	super
super	súper
conoscenza	conocimiento
mettere	poner
aperto	abierto
semplicemente	simplemente
blocco	bloque
blocco	bloqueo
maglia	eslabones
maglia	malla
maglia	camiseta
corsa	recorrido
corsa	carrera
pratica	práctica
commissione	comisión
generalmente	generalmente
attenzione	atención
play	play
caratterizzata	caracterizada
passò	pasó
arco	arco
autorità	autoridad
campi	campos
oggetti	objetos
domenico	domenico
autori	autores
origini	orígenes
abbastanza	suficiente
abbastanza	bastante
bob	bob
tedeschi	alemanes
lettere	cartas
lettere	letras
effetto	efecto
resistenza	resistencia
tentativo	tentativa
tentativo	intento
xix	xix
west	west
orientation	orientation
gestione	gerencia
gestione	gestión
scala	escalera
scala	escala
censimento	censo
chris	chris
die	die
partecipazione	participación
mike	mike
costituito	constituido
vincenzo	vicente
vincenzo	vincenzo
prendere	tomar
modifiche	modificaciones
omonimo	homónimo
canadese	canadiense
canadese	canadienses
scalemajor	scalemajor
passare	pasar
timeaxis	timeaxis
imagesize	imagesize
famiglie	familias
plotarea	plotarea
svedese	sueca
svedese	sueco
australia	australia
match	match
best	best
secoli	siglos
grand	grand
press	press
ottiene	consigue
ottiene	obtiene
esterno	externo
esterno	exterior
sangue	sangre
dateformat	dateformat
sergio	sergio
traduzione	traducción
piani	planes
padova	padua
ricevuto	recibido
intero	entera
intero	entero
pierre	pierre
ghiaccio	hielo
chiaro	claro
trovato	encontrado
cina	china
censiti	censados
justify	justify
alignbars	alignbars
backgroundcolors	backgroundcolors
alpi	alpes
scaleminor	scaleminor
supporto	apoyo
supporto	soporte
nicola	nicolás
nicola	nicola
difficile	difícil
voto	voto
lotta	lucha
ragazzi	muchachos
ragazzi	chicos
india	india
misura	medida
pianta	planta
termini	términos
occhi	ojos
bianca	bianca
bianca	blanca
regioni	regiones
spacewatch	spacewatch
california	california
costruita	construida
spettatori	espectadores
spettatori	televidentes
premi	premios
risposta	respuesta
inserito	introducido
inserito	insertado
nessun	ningún
nessun	ningunos
medio	medio
commenta	comenta
atleta	atleta
soli	solos
soli	soles
culturale	cultural
entrambe	ambas
realizzazione	realización
secondi	segundos
utilizzata	utilizada
modelli	modelos
modelli	plantillas
verrà	vendrá
auto	auto
politiche	políticas
sesso	sexo
ragione	razón
strumenti	instrumentos
strumenti	herramientas
steve	steve
contenuto	contenido
famoso	famoso
terreno	terreno
piedi	pies
notevole	notable
rossa	pelirroja
xiii	xiii
durata	duración
componenti	componentes
analisi	análisis
teatrale	teatral
maggioranza	mayoría
usare	utilizar
usare	usar
appunto	precisamente
tempio	templo
gesù	jesús
quantità	cantidad
joe	joe
concerto	concierto
mani	manos
jones	jones
minori	menores
austriaco	austriaco
austriaco	austríaco
williams	williams
filosofia	filosofía
natale	navidad
natale	navidades
discussioni	discusiones
discussioni	debates
aggiunta	adición
disponibile	disponible
vienna	viena
guardia	guardia
competizione	competición
attivo	activo
conflitto	conflicto
partecipa	participe
partecipa	participa
confine	frontera
stelle	estrellas
crisi	crisis
moderna	moderna
avvocato	abogada
avvocato	abogado
quarta	cuarta
claudio	claudio
bassi	bajos
facciata	fachada
entra	entra
descrizione	descripción
nata	nacida
raggiunto	alcanzado
avendo	teniendo
avendo	habiendo
fondato	fundado
avanti	adelante
conquista	conquista
esistenza	existencia
entrò	entró
canada	canadá
aereo	avión
aereo	avion
anime	anime
anime	almas
economia	economía
devono	deben
regole	normas
regole	reglas
trasmissione	transmisión
air	air
criteri	criterios
sarebbero	serían
pianeta	planeta
segno	signo
romani	romanos
edifici	edificios
pianoforte	piano
acque	aguas
maschi	machos
maschi	varones
bella	bella
argomento	argumento
sapere	saber
doveva	debía
time	time
nessuna	ninguna
scott	scott
guglielmo	guillermo
legno	madera
altare	altar
amministrazione	gerencia
amministrazione	administración
poche	pocas
guest	guest
storie	historias
terminata	finalizada
terminata	terminada
ospedale	hospital
bordo	borde
funzioni	funciones
metodo	método
strutture	estructuras
portare	llevar
portare	traer
battista	bautista
operazioni	operaciones
trono	trono
impianto	implante
nazioni	naciones
simon	simon
simon	simón
image	image
rispettivamente	respectivamente
religione	religión
vecchia	vieja
commerciale	comercial
uscì	salió
arma	arma
indica	indica
house	house
conseguenza	consecuencia
ufficialmente	oficialmente
scene	escenas
teste	cabezas
utile	útil
life	life
royal	royal
vii	vii
mary	mary
aiutare	ayudar
list	list
signore	señor
imperiale	imperial
cristo	cristo
diede	dio
monastero	monasterio
contatto	contacto
diffusione	propagación
diffusione	difusión
lascia	deja
white	white
big	big
tipi	tipos
dollari	dólares
territori	territorios
lavorare	trabajar
gioca	juega
amministratore	administrador
orbita	órbita
orbita	orbita
walter	walter
madrid	madrid
letto	leído
letto	cama
disposizione	disposición
leone	león
ala	ala
genitori	padres
xii	xii
simbolo	símbolo
quinto	quinto
xviii	xviii
ingegnere	ingeniero
bgcolor	bgcolor
luna	luna
resti	restos
argentina	argentina
leggi	lee
leggi	leyes
religioso	religioso
spirito	espíritu
soluzione	solución
fianco	flanco
statistiche	estadísticas
iniziata	iniciada
iniziata	comenzada
ministero	ministerio
niente	nada
computer	computadoras
computer	ordenador
computer	ordenadores
computer	computadora
merito	merezco
merito	mérito
scheda	tarjeta
scheda	pestaña
scheda	ficha
morti	muertes
morti	muertos
settimane	semanas
protezione	protección
bari	bari
ufficio	oficina
filosofo	filósofo
vai	ve
ultime	últimas
harry	harry
danni	daños
danni	danni
danni	daño
atti	actas
atti	actos
chitarrista	guitarrista
azioni	acciones
utilizzare	utilizar
utilizzare	utilice
russa	rusa
xvii	xvii
und	und
numeri	números
ferro	hierro
protetta	protegida
messico	méxico
messico	mexico
normale	normal
traccia	traza
siamo	somos
siamo	estamos
spagnola	española
washington	washington
messaggio	mensaje
entrare	entrar
borgo	burgo
borgo	borgo
out	out
categorie	categorías
parma	parma
united	united
iniziato	iniciado
iniziato	comenzado
geografia	geografía
latitudine	latitud
ovviamente	obviamente
division	division
sonora	sonora
strumento	herramienta
strumento	instrumento
brasiliano	brasileño
colpo	golpe
brian	brian
definitivamente	definitivamente
leggere	lea
leggere	leer
uscito	salido
ipotesi	hipótesis
influenza	influencia
influenza	gripe
vivo	vivo
modalità	modalidad
modalità	modos
modalità	modo
organo	órgano
capire	entender
giallo	amarillo
metropolitana	metro
grecia	grecia
leader	líderes
leader	leader
leader	líder
scienze	ciencias
celebre	célebre
comitato	comite
comitato	comité
etichetta	etiqueta
#aaa	#aaa
scritti	escritos
coda	coda
coda	cola
park	park
considerata	considerada
incidente	incidente
incidente	accidente
xiv	xiv
sostituito	sustituido
sostituito	reemplazado
jim	jim
verona	verona
basilica	basílica
composizione	composición
guido	guido
significato	significado
responsabile	responsable
solid	solid
femmine	hembras
valign	valign
abbiamo	hemos
abbiamo	tenemos
fede	fe
prove	pruebas
prove	ensayos
nemico	enemigo
documenti	documentos
specialità	especialidades
specialità	especialidad
poteri	poderes
young	young
segretario	secretario
istituzione	institución
decreto	decreto
iniziale	inicial
strade	calles
strade	carreteras
strade	caminos
concetto	concepto
venivano	venían
edit	edit
sesto	sexto
sesto	sexta
gradi	grados
lasciare	dejar
rivoluzione	revolución
bill	bill
motori	motores
tiro	tiro
campioni	muestras
campioni	campeones
intitolato	titulado
abitato	habitado
piante	plantas
temperatura	temperatura
imprenditore	emprendedor
imprenditore	contratista
imprenditore	empresario
vivere	vivir
perso	perdido
brescia	brescia
americana	americana
asteroide	asteroide
benedetto	bendecido
benedetto	benito
benedetto	bendito
benedetto	benedicto
scoperta	descubrimiento
culto	culto
guerre	guerras
carta	papel
fuga	escapada
fuga	escapar
fuga	fuga
fuga	huida
fuga	escape
tony	tony
post	post
usata	usada
notare	notar
ungherese	húngaro
macchina	coche
macchina	máquina
cavallo	caballo
decisione	decision
decisione	decisión
obiettivo	objetivo
particolari	detalles
euro	euros
euro	euro
chicago	chicago
oscar	oscar
oscar	óscar
tradizionale	tradicional
enciclopedica	enciclopédico
ciclo	ciclo
ciclo	bucle
vice	vice
viii	viii
internet	internet
presentato	presentado
sovietica	soviético
sovietica	soviética
edward	edward
contenuti	contenidos
scuole	escuelas
reggimento	regimiento
difensore	defensor
sconfitto	derrotado
olio	aceite
possiede	posee
costituita	constituida
conosciuta	conocida
diverso	diferente
diverso	distinto
fisico	físico
talk	talk
pezzi	piezas
critico	crítico
immediatamente	inmediatamente
registrato	registrado
registrato	grabado
raggiunge	alcanza
dubbio	duda
pensiero	pensamiento
ebbero	tuvieron
ebbero	hubieron
commedia	comedia
terre	tierras
realizzata	realizada
introduzione	introducción
dotato	dotado
principio	principio
amm	moa
punta	punta
punta	extremidad
deciso	decidido
alexander	alexander
test	test
caps	caps
egitto	egipto
valori	valores
portiere	portero
avrebbero	tendrían
uefa	uefa
ricerche	búsquedas
dominio	dominio
mantenere	mantener
brown	brown
conti	cuentas
omonima	homónima
parlare	hablar
elemento	item
elemento	elemento
zero	cero
zero	zero
giocare	jugar
cittadini	ciudadanos
compare	aparece
compare	compadre
resta	quédate
day	day
corrente	corriente
hall	hall
scultore	escultor
jan	jan
articoli	articulos
articoli	artículos
videogioco	videojuego
amministrativa	administrativa
nipote	sobrino
nipote	nieto
nipote	nieta
nipote	sobrina
title	title
php	php
dischi	discos
polacco	polaco
riforma	reforma
posso	puedo
statua	estatua
software	software
speciali	especiales
necessità	necesidad
antichi	antiguos
attacchi	ataques
principessa	princesa
debutto	debut
montagna	montañas
montagna	montaña
malattia	enfermedad
livelli	niveles
professore	profesor
felice	feliz
nera	negra
denominazione	denominación
flotta	flota
argentino	argentino
salvatore	salvatore
salvatore	salvador
comportamento	comportamiento
comportamento	conducta
corona	corona
costituzione	constitución
combattimento	combate
bisogno	necesidad
copyright	copyright
nostra	nuestra
parlamento	parlamento
caduta	caída
visione	visión
sviluppato	desarrollado
mette	pone
mette	mette
rivolta	levantamiento
rivolta	revuelta
capitolo	capitulo
capitolo	capítulo
sovrano	soberano
sovrano	soberana
vide	vió
vide	vio
vide	vide
dvd	dvd
consenso	consenso
consenso	consentimiento
tornò	regresó
tornò	volvió
vedo	veo
pisa	pisa
compito	tarea
notizie	noticias
rilievo	relieve
pio	pío
pio	pio
concorso	concurso
utilizzati	utilizados
inglesi	ingleses
france	france
greca	griega
partenza	partida
partenza	salida
sam	sam
rischio	riesgo
monti	montes
monti	monti
nazione	nación
primavera	primavera
agente	agente
nazionalità	nacionalidad
nazionalità	nacionalidades
college	college
aperta	abierta
umano	humano
beni	bienes
sardegna	cerdeña
indipendenza	independencia
materiali	materiales
eccentricità	excentricidad
eccentricità	excentricidades
banda	banda
commercio	comercio
png	png
bianchi	bianchi
bianchi	blancos
legate	atadas
nove	nueve
diego	diego
ali	alas
ali	ali
completa	completa
can	can
ferrovia	ferrocarril
svolge	desempeña
televisione	televisión
sceneggiatura	guión
laura	laura
basato	basado
riccardo	riccardo
riccardo	richard
riccardo	ricardo
fiori	flores
vergine	virgen
spettacolo	espectáculo
spettacolo	show
byte	octetos
byte	byte
byte	bytes
byte	octeto
posizioni	posiciones
polonia	polonia
toscana	toscana
toscana	toscano
entrata	entrada
fanteria	infantería
piero	piero
admin	admin
lasciato	dejado
ricorda	recuerda
costruire	construir
canto	canto
mancanza	falta
alex	álex
alex	alex
modifica	modificación
modifica	editar
marino	marino
coro	coro
frase	frase
industria	industria
semifinali	semifinales
uccidere	matar
leggera	ligera
asia	asia
lord	lord
atp	atp
comunicazione	comunicación
chiuse	esclusas
chiuse	cerradas
hockey	hockey
rugby	rugby
scrittrice	escritora
norvegese	noruego
serve	sirve
johnson	johnson
politici	políticos
racconto	cuento
umani	humanos
bretagna	bretaña
vescovi	obispos
potente	potente
potente	poderosa
potente	poderoso
esclusivamente	exclusivamente
tribù	tribu
tribù	tribus
personalità	personalidad
finalista	finalista
indicare	indique
indicare	indicar
interpretazione	interpretación
christian	christian
definizione	definición
partecipare	participar
convento	convento
interpretata	interpretada
portale	portal
province	provincias
legato	atado
protagonisti	protagonistas
assegnato	asignado
nemici	enemigos
errore	error
mondadori	mondadori
recente	reciente
semi	semi
settanta	setenta
leonardo	leonardo
originariamente	originalmente
universo	universo
domenica	domingo
pressione	presión
arthur	arthur
ferdinando	fernando
limite	límite
presa	tomada
lasciò	dejó
first	first
ottanta	ochenta
medici	médicos
chilometri	kilómetros
chilometri	kilometros
volontà	voluntad
sicuramente	definitivamente
assenza	ausencia
filmografia	filmografía
porte	puertas
orario	horario
indipendente	independiente
caratteristica	característica
abilità	habilidades
abilità	habilidad
governatore	gobernadora
governatore	gobernador
giusto	justo
catastale	catastral
blue	blue
umana	humana
classica	clásica
materia	materia
creata	creada
patria	patria
dipinto	pintado
date	fechas
carico	carga
fenomeno	fenómeno
roger	roger
stesse	mismas
interamente	enteramente
alleanza	alianza
farlo	hacerlo
forti	fuertes
vie	vie
copie	copias
copie	ejemplares
gianni	gianni
esce	sale
condizione	condición
regime	régimen
prevalentemente	predominantemente
lancio	lanzamiento
industriale	industrial
aspetti	espere
aspetti	aspectos
citato	citado
rivela	revela
centrocampista	centrocampista
linguaggio	lenguaje
facilmente	fácilmente
espressione	expresión
iso	iso
neat	neat
solista	solista
appartiene	pertenece
manifestazione	manifestación
pieno	lleno
belga	belga
giustizia	justicia
venti	veinte
venti	vientos
collezione	colección
ritiro	retiro
ritiro	retirada
firma	firma
adesso	ahora
siti	sitios
poesia	poesía
poesia	poema
occhio	ojo
cavaliere	caballero
cavaliere	cavaliere
cavaliere	jinete
inizi	comience
segreto	secreto
santuario	santuario
little	little
miss	miss
taylor	taylor
racconti	relatos
racconti	cuentos
gas	gas
gas	gases
lady	lady
relativa	relativa
latina	latina
trovava	encontraba
superiori	superiores
prestito	préstamo
baviera	baviera
ciclista	ciclista
aerei	aviones
signora	señora
fondatore	fundador
sindaco	alcalde
sindaco	alcaldesa
visita	visita
dinastia	dinastía
identità	identidades
identità	identidad
dimensione	dimensión
dimensione	tamaño
martino	martino
finalmente	finalmente
sacro	sagrado
sacro	sacro
emilia	emilia
basta	basta
portata	alcance
portata	caudal
mezzi	medios
salute	salud
fondamentale	fundamental
chiara	clara
cori	coros
cori	cori
veneto	veneto
veneto	véneto
maurizio	mauricio
oriente	oriente
proprietario	propietario
proprietario	dueño
principi	principios
animale	animal
volumi	volúmenes
marie	marie
programmi	programas
finali	finales
grave	grave
siena	siena
davis	davis
ricordo	recuerdo
real	real
chiusura	cierre
cominciò	comenzó
economico	económico
archivio	archivo
fortemente	fuertemente
contesto	contexto
matteo	mateo
jackson	jackson
albert	albert
https	https
definito	definido
elena	elena
vale	vale
ray	ray
domanda	pregunta
arrivare	llegar
svezia	suecia
studenti	estudiantes
occupa	ocupa
habitat	hábitats
habitat	habitat
habitat	hábitat
classico	clásico
faccia	cara
pop	pop
catania	catania
cristiana	cristiana
permesso	permitido
permesso	permiso
challenger	challenger
viola	morado
viola	púrpura
viola	viola
varietà	variedades
varietà	variedad
venendo	viniendo
km²	km²
circuito	circuito
disegno	dibujo
disegno	diseño
antiche	antiguas
discorso	discurso
targa	matrícula
attaccante	atacante
saranno	serán
saranno	estarán
reazione	reacción
spedizione	envio
spedizione	expedición
spedizione	envío
medicina	medicina
eric	eric
abbazia	abadía
muto	silenciar
muto	mudo
piloti	pilotos
eccezione	excepción
sessanta	sesenta
vincere	ganar
suddivisione	subdivisión
compreso	incluyendo
successive	sucesivas
posteriore	trasero
posteriore	posterior
posteriore	trasera
faceva	hacía
ferrari	ferrari
calabria	calabria
continuò	continuó
continuò	siguió
dizionario	diccionario
giornale	periódico
provinciale	provincial
home	home
registrazione	registro
registrazione	grabación
religiosa	religiosa
girl	girl
medievale	medieval
incontra	conoce
ungheria	hungría
possesso	posesión
monumenti	monumentos
trasmessa	transmitida
portoghese	portugues
portoghese	portugués
sezioni	secciones
contemporanea	contemporánea
fuso	fundido
fuso	huso
colonne	columnas
utilizzando	usando
utilizzando	utilizando
barbara	barbara
barbara	bárbara
giardino	jardín
giardino	jardin
foglie	hojas
street	street
kevin	kevin
green	green
savoia	saboya
interventi	intervenciones
compagni	camaradas
compagni	compañeros
idee	ideas
assedio	asedio
indicato	indicado
matematico	matemático
confini	fronteras
www	www
spada	espada
consiste	consiste
regolare	ajustar
regolare	regular
civili	civiles
online	online
naturali	naturales
aumento	aumento
lavora	trabaja
chiave	clave
chiave	llave
ove	ove
seguire	siga
seguire	seguir
penso	pienso
penso	creo
compagno	camarada
compagno	compañero
scozzese	escocés
affari	negocio
affari	negocios
irlandese	irlandesa
irlandese	irlandés
vetrina	escaparate
albero	árbol
relazioni	informes
relazioni	relaciones
augusto	augusto
esecuzione	ejecución
raggiunse	alcanzó
parziale	parcial
perse	perdió
vincendo	ganando
arrivò	llegó
successi	exitos
successi	éxitos
reggio	reggio
esempi	ejemplos
documento	documento
caratterizzato	caracterizado
nucleo	núcleo
insegnante	profesor
insegnante	maestra
insegnante	profesora
hans	hans
ebrei	judios
ebrei	judíos
ebrei	hebreos
congresso	congreso
patrick	patrick
artiglieria	artillería
gentile	amable
jazz	jazz
farsi	farsi
davvero	realmente
concerti	conciertos
gigante	gigante
trieste	trieste
arcidiocesi	arquidiócesis
arcidiocesi	archidiócesis
lasciando	dejando
barcellona	barcelona
karl	karl
salvare	salvar
minimo	mínimo
vicina	vecina
dando	dando
soggetti	sujetos
ottenendo	consiguiendo
ottenendo	obteniendo
ordini	órdenes
ordini	pedidos
ordini	ordene
ordini	ordenes
dimmi	dime
giudizio	juicio
autonoma	autónoma
tesi	tesis
opinione	opinion
opinione	opinión
anteriore	delantera
anteriore	delantero
mediterraneo	mediterráneo
jacques	jacques
laurea	licenciatura
laurea	graduación
moto	motos
vittime	victimas
vittime	víctimas
colonia	colonia
facoltà	facultades
facoltà	facultad
tuo	tuyo
somma	suma
crescita	crecimiento
avvenne	aconteció
regionali	regionales
giudice	juez
lati	lados
andrew	andrew
messina	mesina
messina	messina
recenti	recientes
cambiare	cambiar
portogallo	portugal
renato	renato
americani	americanos
americani	estadounidenses
tokyo	tokyo
tokyo	tokio
alleati	aliados
quota	cupo
quota	cuota
lontano	lejano
lontano	lejos
variante	variante
dichiarato	declarado
estremamente	extremadamente
françois	françois
leggenda	leyenda
disponibili	disponibles
costante	constante
precedentemente	anteriormente
precedentemente	previamente
generazione	generación
piattaforma	plataforma
belgio	bélgica
belgio	belgica
tua	tuya
modena	modena
modena	módena
famosa	famosa
biografia	biografía
digitale	digital
mente	miente
mente	mente
omicidio	asesinato
omicidio	homicidio
fotografia	fotografía
umberto	humberto
umberto	umberto
contemporaneamente	contemporáneamente
caterina	caterina
caterina	catalina
nostro	nuestro
abate	abad
mauro	mauro
tommaso	tomás
quinta	quinta
aldo	aldo
artistica	artística
dotata	dotada
comunista	comunista
kim	kim
alfonso	alfonso
pubblicati	publicados
dentro	adentro
dentro	dentro
vantaggio	ventaja
riconoscimento	reconocimiento
game	game
mandato	mandato
interpreti	intérpretes
ampio	amplio
zio	tío
pensare	pensar
rose	rose
rose	rosas
muore	muere
colonnello	coronel
visibile	visible
ritratto	retrato
scienza	ciencia
luciano	luciano
termina	finaliza
termina	finalizar
termina	termina
vendita	venta
perdita	pérdida
sorge	surge
this	this
brigata	brigada
combattere	luchar
parere	dictamen
novanta	noventa
carl	carl
generi	géneros
tecnologia	tecnología
scrittura	escritura
cover	cover
cover	carcasas
irlanda	irlanda
virginia	virginia
suono	sonido
generali	generales
attiva	activar
attiva	activa
attiva	habilitar
matematica	matemáticas
matematica	matemática
condotto	conducto
completo	completo
tipico	típico
ceco	checo
passione	pasión
ruoli	roles
artistico	artística
artistico	artístico
andré	andré
flag	flag
moderno	moderno
interni	interiores
concessione	concesión
anderson	anderson
affrontare	enfrentar
amministrativo	administrativo
tim	tim
votare	votar
trattamento	tratamiento
contributo	contribución
assoluto	absoluta
assoluto	absoluto
cimitero	cementerio
salvo	excepto
salvo	salvo
trofeo	trofeo
espansione	expansión
amicizia	amistad
senato	senado
verdi	verdi
verdi	verdes
fumetti	historietas
fumetti	cómics
originario	originario
temi	temas
invasione	invasión
belle	belle
belle	bellas
lewis	lewis
neri	negras
neri	negros
chiedere	preguntar
chiedere	pedir
mille	mil
inverno	invierno
componente	componente
avviso	aviso
ottocento	ochocientas
ottocento	ochocientos
diffuso	difuso
divisa	dividida
atene	atenas
alan	alan
tela	lienzo
personali	personales
emanuele	emanuele
emanuele	manuel
sposa	novia
collegio	internado
marchese	marqués
praticamente	prácticamente
victor	victor
champions	champions
previsto	previsto
pokémon	pokémon
girato	filmado
cavalieri	caballeros
cavalieri	jinetes
nick	nick
ivan	iván
billy	billy
pezzo	pieza
pezzo	pedazo
sovietico	soviético
novecento	novecientos
contenente	conteniendo
rappresentato	representado
automatico	automático
automatico	automática
napoleone	napoleón
resa	rendición
specialmente	especialmente
promosso	promocionado
promosso	promovido
inclinata	inclinada
corsi	cursos
cronologia	cronología
cronologia	historial
lazio	lazio
lazio	lacio
anima	alma
song	song
evidente	evidente
wilson	wilson
sufficiente	suficiente
stretto	apretado
stretto	estrecho
dialetto	dialecto
lavorato	trabajado
dodici	doce
texas	tejas
texas	texas
immediata	inmediata
fabio	fabio
emilio	emilio
regola	regla
clima	clima
pil	pib
tanti	tantos
cittadino	ciudadano
pittura	pintura
enorme	enorme
simone	simone
google	google
men	men
presentano	presentan
atletica	atletismo
scientifico	científico
tenente	teniente
vento	viento
howard	howard
gaetano	gaetano
cristiano	cristiano
laterali	laterales
braccio	brazo
angolo	ángulo
angolo	rincón
angolo	esquina
attori	actores
formata	formada
solare	solar
specifico	específico
danese	danés
angeli	ángeles
eclittica	eclíptica
movimenti	movimientos
chiama	llama
spalle	hombros
back	back
adam	adam
favorevoli	favorables
sfida	reto
sfida	desafío
will	will
vorrei	quisiera
semifinale	semifinal
avversario	oponente
avversario	adversario
interpreta	interpreta
documentario	documental
lunghi	largos
equipaggio	tripulación
facile	fácil
prevede	predice
stazioni	estaciones
studiosi	estudiosos
studiosi	eruditos
parrocchia	parroquia
estende	extiende
impianti	implantes
impianti	instalaciones
lombardia	lombardia
lombardia	lombardía
windows	windows
relativamente	relativamente
leggermente	ligeramente
fortuna	fortuna
traffico	tráfico
prestazioni	rendimiento
prestazioni	prestaciones
jimmy	jimmy
stanno	están
trenta	treinta
trenta	trenta
segnali	señales
tornato	vuelto
cercando	buscando
basata	basada
society	society
ampia	amplia
ciao	hola
esposizione	exposición
ford	ford
alessandria	alejandría
assemblea	asamblea
foresta	bosque
dante	dante
corpi	cuerpos
musicisti	músicos
miniserie	miniserie
ispirato	inspirado
ispirato	inspirada
piena	plena
piena	llena
penisola	península
force	force
potevano	podían
cinquanta	cincuenta
agostino	agustín
agostino	agostino
slalom	slalom
paura	temor
paura	miedo
history	history
motivazione	motivación
anti	anti
sostegno	apoyo
candidato	candidata
candidato	candidato
storiche	históricas
cannoni	cañones
infanzia	niñez
infanzia	infancia
inviato	fijado
inviato	enviado
religiose	religiosas
capace	capaz
lettura	lectura
originali	originales
occupazione	ocupación
occupazione	empleo
anne	anne
popolazioni	poblaciones
fasi	pasos
fasi	etapas
fasi	fases
controllare	controlar
controllare	comprobar
sci	esquí
capelli	cabello
capelli	pelo
restauro	restauración
daniele	daniel
daniele	daniele
possibili	posibles
detentore	poseedor
colle	colle
tastiere	teclados
estratto	extracto
costo	coste
costo	costo
aquila	águila
aquila	aguila
parrocchiale	parroquial
romanzi	novelas
fusione	fusión
avevo	tenía
saga	saga
assoluta	absoluta
assolutamente	absolutamente
fama	fama
autonomia	autonomía
semplificata	simplificada
goals	goals
vino	vino
assistente	asistente
assistente	ayudante
remix	remix
vincitori	ganadores
copertina	portada
ricostruzione	reconstrucción
vicenza	vicenza
operativo	operativo
boy	boy
johann	johann
alice	alicia
alice	alice
perde	pierde
pericolo	peligro
duomo	duomo
legati	atados
suolo	suelo
cast	reparto
cast	cast
cast	elenco
iniziativa	iniciativa
tabella	cuadro
tabella	tabla
organizzato	organizado
dovuta	debida
fontana	fontana
johnny	jhonny
johnny	johnny
applicazione	aplicación
sogno	sueño
patrimonio	patrimonio
ragazze	muchachas
ragazze	niñas
ragazze	chicas
sposato	casado
ferrara	ferrara
legata	ligada
legata	atada
compresa	incluida
cellule	células
risorse	recursos
commissario	comisionado
commissario	comisario
occidentali	occidentales
ugo	hugo
ugo	ugo
enzo	enzo
jeff	jeff
asse	eje
intervista	entrevista
north	north
vota	vote
vota	vota
successione	sucesión
lucio	lucio
critiche	críticas
south	south
australiano	australiano
commerciali	comerciales
chiuso	cerrado
tomba	tumba
frutto	fruto
segnalazione	reporte
votazioni	votaciones
estensione	extensión
amica	amiga
potrebbero	podrían
parete	pared
dolce	dulce
margherita	margarita
pellicola	película
ragioni	razones
vinta	ganada
diametro	diámetro
sir	sir
bergamo	bérgamo
bergamo	bergamo
dan	dan
anthony	anthony
distruzione	destrucción
mantova	mantua
usando	usando
usando	utilizando
tennista	tenista
modi	maneras
trasferimento	transferencia
trasferimento	traslado
perdere	perder
treni	trenes
chimica	química
long	long
livorno	livorno
usati	usados
quotidiano	diario
romania	rumania
romania	rumanía
trama	trama
ceca	ceca
ceca	checa
anello	anillo
passeggeri	pasajeros
bruce	bruce
golden	golden
piemonte	piamonte
michel	michel
console	consola
console	cónsul
console	consolas
disputa	disputa
marcia	marcha
marcia	marcia
not	not
offre	ofrece
pallavolo	voleibol
marcello	marcello
conoscere	conocer
vendite	ventas
residenza	residencias
residenza	residencia
ducato	ducado
trasporti	transportes
trasporti	transporte
liberazione	liberación
ricco	rico
formare	formar
profondità	profundidad
navale	naval
edoardo	eduardo
alba	alba
alba	amanecer
ripresa	reanudación
alfred	alfred
nobili	nobles
bacino	pelvis
bacino	cuenca
bacino	embalse
rocca	peñón
rocca	rocca
story	story
carcere	cárcel
carcere	prisión
scientifica	científica
aggiunto	agregado
aggiunto	añadido
rifugio	refugio
alte	altas
andy	andy
fortezza	fortaleza
annunciato	anunciado
annunciato	anunció
annunciato	anunciada
personalmente	personalmente
bosco	bosco
pelle	piel
mise	puso
elevata	elevada
classificazione	clasificación
tranne	excepto
cambridge	cambridge
profilo	perfil
colpi	golpes
barone	barón
barone	baron
catalogo	catálogo
catalogo	catalogo
corretto	corregido
corretto	correcto
migliorare	mejorar
federale	federal
giulia	giulia
giulia	julia
indiano	indio
indiano	hindú
pubblicazioni	publicaciones
ammiraglio	almirante
cantone	cantón
istruzione	educación
istruzione	instrucción
saggio	sabio
ambienti	entornos
ambienti	ambientes
socialista	socialista
cagliari	cagliari
produrre	producir
caratteri	caracteres
apparizione	aparición
conservato	conservado
bibliografia	bibliografía
interessante	interesante
doppia	dobles
doppia	doble
orientali	orientales
are	are
purtroppo	desafortunadamente
purtroppo	lamentablemente
purtroppo	desgraciadamente
rimanere	quedarse
rimanere	permanecer
olimpiadi	olimpiadas
avventura	aventura
possiamo	podemos
assunto	contratado
esercizio	ejercicio
impegno	compromiso
disegni	dibujos
disegni	diseños
british	british
urbano	urbano
perdite	pérdidas
perdite	fugas
collana	collar
town	town
cane	perro
aggiungere	agregar
blues	blues
death	death
ricca	rica
selezione	selección
allen	allen
mobile	móvil
hollywood	hollywood
interrotta	interrumpida
classificata	clasificada
fabbrica	fabrica
fabbrica	fábrica
inserita	insertada
inserita	introducida
reali	reales
norma	norma
douglas	douglas
riferimenti	referencias
continuare	continuar
vito	vito
teresa	teresa
aeronautica	aeronáutica
what	what
relativi	relativos
east	east
processi	procesos
muro	muro
disney	disney
capito	entendido
colpito	golpeado
consigliere	consejera
consigliere	consejero
miller	miller
fecero	hicieron
down	down
segna	marcar
scomparsa	desaparición
scomparsa	desaparecida
giuliano	julián
giuliano	giuliano
giuliano	juliano
fred	fred
pesante	pesado
pesante	pesada
errori	errores
piede	pie
impiegato	empleado
iniziarono	empezaron
riconosciuto	reconocido
civica	cívica
uguale	iguala
uguale	igual
ricordare	recordar
diplomatico	diplomático
normalmente	normalmente
ramo	rama
nomina	nombramiento
sicuro	seguro
fox	fox
gordon	gordon
veloce	rápido
veloce	rápida
manager	manager
passando	pasando
wrestling	wrestling
danimarca	dinamarca
scozia	escocia
bocca	boca
end	end
lunghe	largas
seguendo	partidarias
seguendo	siguiendo
criminale	criminal
trasmesso	transmitido
ritorna	regresa
ritorna	volver
ritorna	vuelve
acido	ácido
francesca	francesca
francesca	francisca
francesca	frances
ludovico	ludovico
elisabetta	isabel
elisabetta	elizabeth
robin	robín
robin	robin
who	who
puoi	puedes
percussioni	percusión
charlie	charlie
fiducia	confianza
realizzati	realizados
org	org
svolto	desempeñado
torri	torres
battaglione	batallón
fiat	fiat
semplici	sencillos
semplici	sencillas
semplici	simples
salto	salto
aziende	empresas
fabrizio	fabrizio
raggio	rayo
frequenza	frecuencia
atleti	atletas
tornei	torneos
alti	altos
erede	heredera
erede	heredero
desiderio	deseo
desiderio	anhelo
sacra	sagrada
matt	matt
lancia	lancia
lancia	lanza
ken	ken
faccio	hago
chiamati	llamados
inserimento	inserción
lucia	lucía
lucia	lucia
popolari	populares
pena	pena
bel	bel
infinito	infinito
trasferito	transferido
trasferito	trasladado
richieste	peticiones
richieste	solicitudes
minaccia	amenaza
jane	jane
marc	marc
girolamo	girolamo
girolamo	jerónimo
oceano	océano
pensa	piensa
scritte	escritas
recentemente	recientemente
sequenza	secuencia
amante	amante
rilevante	relevante
pesi	pesas
pesi	pesos
argomenti	argumentos
alfredo	alfredo
uscire	salir
voleva	quería
giapponesi	japonesas
giapponesi	japoneses
missioni	misiones
vittima	víctima
vittima	victima
dopoguerra	posguerra
dopoguerra	postguerra
riva	riva
necessaria	necesaria
tribunale	tribunal
metodi	métodos
prezzo	precio
limiti	límites
oxford	oxford
venga	venga
autunno	otoño
meccanica	mecánica
cavalleria	caballería
basi	bases
descritto	descrito
archi	arcos
definita	definida
legame	vínculo
boston	boston
sanremo	sanremo
comunemente	comúnmente
trento	trento
trasferita	transferida
trad	trad
perugia	perugia
avventure	aventuras
rocco	rocco
congregazione	congregación
finlandese	finés
finlandese	finlandés
finisce	termina
finisce	acaba
gamma	gama
gamma	gamma
heart	heart
eva	eva
civiltà	civilización
civiltà	civilizaciones
panorama	panorama
land	land
vecchi	viejos
dipinti	pinturas
golfo	golfo
dillo	dilo
gabriele	gabriel
veramente	realmente
favorevole	favorable
trasformazione	transformación
attuali	actuales
pre	pre
aumentare	aumentar
wild	wild
prigionieri	prisioneros
prigionieri	presos
conduttore	presentador
agricoltura	agricultura
israele	israel
accusa	acusa
accusa	acusación
azzurro	azul
carri	vagones
carri	carretas
responsabilità	responsabilidades
responsabilità	responsabilidad
road	road
franz	franz
morire	morir
gregorio	gregorio
dark	dark
fame	hambre
treno	tren
davide	davide
davide	david
videogiochi	videojuegos
last	last
fan	fans
fan	fan
chiedo	pregunto
chiedo	pido
chiedo	solicito
pdf	pdf
copia	copia
privato	privada
privato	privado
elevato	elevado
morale	moral
henri	henri
aires	aires
eroe	héroe
alpino	alpino
adriano	adriano
tipologia	tipología
segni	signos
incluso	incluido
acquistato	comprado
greci	griegos
professionista	profesional
avanzata	avanzada
pasquale	pasquale
pasquale	pascual
pontificio	pontificio
proposto	propuesto
espresso	espresso
espresso	expresado
espresso	expreso
introdotto	introducido
sassonia	sajonia
fiumi	rios
fiumi	ríos
friedrich	friedrich
uccelli	aves
uccelli	pájaros
status	status
status	estatus
cavalli	caballos
organizzata	organizada
variabile	variable
mix	mix
pianista	pianista
cibo	comida
annuale	anual
cristiani	cristianos
lavorò	trabajó
migliaia	miles
migliaia	millares
moore	moore
destinato	destinado
divinità	divinidad
divinità	deidad
acciaio	acero
campagne	campañas
corrispondenza	correspondencia
corrispondenza	concordancia
violino	violín
bonus	bonus
bonus	bono
bonus	bonificación
bonus	bonos
ferrovie	ferrocarriles
campanile	campanario
campanile	campanile
settimo	séptimo
tradizionali	tradicionales
differenze	diferencias
razza	raza
laboratorio	laboratorio
destino	doom
abbandonato	abandonado
corrispondente	corresponsal
corrispondente	correspondiente
baseball	baseball
baseball	béisbol
sostituzione	reemplazo
sostituzione	sustitución
oliver	oliver
brevi	breves
limitata	limitada
avrà	tendrá
costi	costos
costi	costes
occasioni	ocasiones
probabile	probable
ryan	ryan
prefettura	prefectura
interessi	intereses
hot	hot
fornire	proporcionar
opposizione	oposición
istituzioni	instituciones
poesie	poemas
dura	dura
elettronica	electrónica
eliminazione	eliminación
monete	monedas
pareti	paredes
stone	stone
decisamente	definitivamente
decisamente	decididamente
convinto	convencido
spaziale	espacial
arabo	árabe
dave	dave
torrente	torrente
sinistro	siniestro
menzionato	mencionado
vuoi	quieres
marmo	mármol
sky	sky
cambia	cambiar
cambia	cambia
indiana	indiana
russell	russel
russell	russell
scontri	enfrentamientos
way	way
periodi	periodos
periodi	épocas
periodi	períodos
commento	comentario
composti	compuestos
nostri	nuestros
terrestre	terrícola
terrestre	terrestre
gloria	gloria
jonathan	jonathan
poté	pudo
western	western
andato	ido
turchia	turquía
localizzazione	localización
relativo	relativo
continuo	continúo
continuo	continuo
sun	sun
classi	clases
alternativa	alternativa
cognome	apellidos
cognome	apellido
realizza	realiza
speranza	esperanza
esattamente	exactamente
sembrano	parecen
schermo	pantalla
norvegia	noruega
power	power
women	women
riduzione	reducción
distretti	distritos
manuale	manual
conferenza	conferencia
like	like
venduto	vendido
dick	dick
varianti	variantes
assume	contrata
assume	asume
pesce	pescado
pesce	pez
macchine	máquinas
gerusalemme	jerusalem
gerusalemme	jerusalén
alberi	arboles
alberi	árboles
batterista	baterista
conclude	concluye
decenni	decenios
decenni	decadas
decenni	décadas
punk	punk
salerno	salerno
musiche	músicas
riviste	revistas
good	good
violenza	violencia
jason	jason
ridotto	reducido
considerazione	consideración
confronto	comparación
valutazione	valoración
valutazione	evaluación
chiaramente	claramente
canali	canales
estremità	extremos
regio	regio
universale	universal
considerati	considerados
inutile	inútil
successore	sucesor
claude	claude
fascista	fascista
conservazione	conservación
conservazione	preservación
offerta	oferta
roy	roy
bartolomeo	bartolomé
bartolomeo	bartolomeo
senatore	senador
arrestato	detenido
arrestato	arrestado
colspan	colspan
soldi	dinero
capisce	entiende
propone	propone
arrivando	llegando
indietro	detrás
indietro	atrás
bernard	bernard
democratico	demócrata
democratico	democrático
nozze	boda
include	incluye
misure	medidas
stub	stub
risolvere	resolver
ombra	sombra
giunta	junta
year	year
concilio	concilio
paola	paola
logo	logo
logo	logotipo
deputato	congresista
deputato	diputado
virtù	virtudes
virtù	virtud
agenzia	agencia
master	master
master	máster
partiti	partidos
altitudine	altitud
cerimonia	ceremonia
distrutto	destruido
boss	boss
oratorio	oratorio
riconoscimenti	reconocimientos
riconoscimenti	galardones
superare	superar
capi	jefes
free	free
sostanza	sustancia
sostanza	substancia
spiega	explica
bad	bad
varia	varia
varia	varía
ancona	ancona
ospite	invitado
ospite	huésped
versi	versos
potrà	podrá
organi	órganos
sofia	sofía
medaglie	medallas
religiosi	religiosos
tag	tag
jordan	jordan
paragrafo	párrafo
confederazione	confederación
special	special
musical	musicales
musical	musical
navigazione	navegación
performance	desempeño
performance	performance
box	box
bernardo	bernardo
raffaele	raffaele
raffaele	rafael
cambiato	cambiado
tipica	típica
venire	venir
eugenio	eugenio
portando	trayendo
comprendeva	incluía
comprendeva	comprendía
osservazione	observación
classifiche	clasificaciones
corea	corea
html	html
formazioni	formaciones
copertura	cobertura
costantinopoli	constantinopla
larghezza	anchura
larghezza	ancho
dettagli	detalles
vendetta	venganza
garibaldi	garibaldi
gian	gian
clemente	clemente
abbiano	tengan
martire	mártir
visse	vivió
pesanti	pesadas
pesanti	pesados
spazi	espacios
yard	yard
preparazione	preparación
carolina	carolina
condannato	condenado
esperto	experto
rappresentanti	representantes
cento	cento
cento	cien
voi	ustedes
cucina	gastronomía
cucina	cocina
einaudi	einaudi
poste	poste
poste	correos
sepolto	enterrado
specifica	especifica
specifica	especificación
specifica	específica
costellazione	constelación
eccellenza	excelencia
pieve	pieve
ideale	ideal
unite	unidas
firmato	firmado
sconfitte	derrotas
prevedeva	preveía
crea	crea
castel	castel
ricordi	recuerdas
ricordi	recuerdos
ricordi	recuerde
system	system
nicolas	nicolas
umanità	humanidad
montana	montana
baby	baby
discesa	descenso
cristina	cristina
terremoto	terremoto
cemento	cemento
space	space
legale	legal
insediamento	asentamiento
ucraina	ucrania
ucraina	ucraniana
tasso	tejón
esistente	existente
kelly	kelly
private	privadas
sabato	sábados
sabato	sábado
sabato	sabado
portano	llevan
portano	traen
qualificazione	calificación
qualificazione	cualificación
arrivato	llegado
cause	causas
serata	velada
istituito	instituido
agenti	agentes
descrive	describe
tastiera	teclado
veicoli	vehículos
veicoli	vehiculos
fatte	hechas
accetta	acepta
clan	clan
clan	clanes
impatto	impacto
gary	gary
programmazione	programación
vicini	vecinos
fattori	factores
bambina	niña
diviso	dividido
dead	dead
sessuale	sexual
praga	praga
turco	turco
dimostra	demuestra
steven	steven
statue	estatuas
sto	estoy
centinaia	cientos
centinaia	centenares
pavia	pavía
great	great
rappresentante	representante
tradotto	traducido
min	min
old	old
dolore	dolor
studiare	estudiar
impossibile	imposible
vissuto	vivido
wayne	wayne
accademico	académico
gino	gino
segnale	señal
chiesto	preguntado
abbandonare	abandonar
manifestazioni	manifestaciones
entità	entidad
entità	entidades
portarono	trajeron
tensione	voltaje
tensione	tensión
toni	toni
produce	produce
milanese	milanesa
hamilton	hamilton
progettato	diseñado
insegnamento	enseñanza
considerare	considerar
debutta	estrena
conferma	confirmar
conferma	confirma
conferma	confirmación
tradizioni	tradiciones
eventuale	eventual
danza	danza
tentativi	intentos
tentativi	tentativas
sostiene	sostiene
sostiene	apoya
turismo	turismo
chiunque	cualquiera
popoli	pueblos
inter	inter
privo	desprovisto
chimico	químico
vasta	extensa
vasta	amplia
vasta	vasta
sydney	sídney
sydney	sidney
sydney	sydney
compagnie	compañias
compagnie	compañías
segreti	secretos
pietroburgo	petersburgo
vivono	viven
magia	magia
christopher	christopher
stranieri	extranjeros
associazioni	asociaciones
eseguito	ejecutado
patto	pacto
candidatura	candidatura
sánchez	sánchez
drago	drago
drago	dragón
prato	prato
prato	césped
prato	prado
ligure	ligure
fedeli	fieles
bryan	bryan
iscrizione	inscripción
dubbi	dudas
prigione	prisión
conclusione	conclusión
puntate	apunten
manca	falta
britannici	británicos
utc	utc
tecnici	técnicos
dimostrato	demostrado
giancarlo	giancarlo
collina	colinas
collina	colina
collina	cerro
kong	kong
contrasto	contraste
animazione	animación
recupero	recuperación
corporation	corporación
corporation	corporation
eliminato	eliminado
conserva	conserva
scambio	intercambio
gatto	gato
elettrico	eléctrica
elettrico	eléctrico
esame	examen
procedure	procedimientos
requisiti	requisitos
cilindri	cilindros
ross	ross
rito	rito
densità	densidades
densità	densidad
maurice	maurice
decennio	decenio
decennio	década
esemplare	espécimen
esemplare	ejemplar
araldica	heráldica
miei	míos
miei	mis
battaglie	batallas
santiago	santiago
romeo	romeo
gold	gold
giurista	jurista
proposte	propuestas
schema	esquema
his	his
corrado	corrado
corrado	conrado
vasto	extenso
vasto	vasto
iata	iata
inferiori	inferiores
nba	nba
clark	clark
rapper	rapero
rapper	raperos
romagna	romaña
silvio	silvio
modificare	modificar
sesta	sexta
ernesto	ernesto
pacifico	pacífico
pacifico	pacifico
parzialmente	parcialmente
adams	adams
voglia	quiera
amsterdam	ámsterdam
amsterdam	amsterdam
treviso	treviso
esperienze	experiencias
fantasy	fantasy
vocale	vocal
polo	polo
indice	índice
imprese	empresas
castelli	castillos
tetto	azotea
tetto	techo
tetto	tejado
here	here
pier	pier
teologo	teólogo
recuperare	recuperar
recuperare	recuperarse
persino	incluso
coste	costas
florida	florida
utili	utiles
utili	útiles
uccide	mata
playoff	playoff
playoff	playoffs
vuoto	vacío
vuoto	vacio
gilbert	gilbert
stabile	estable
detective	detective
detective	detectives
rappresentata	representada
friuli	friuli
bell	bell
questioni	cuestiones
ingegneria	ingeniería
vincent	vincent
sound	sound
juventus	juventus
ordinato	ordenada
ordinato	ordenado
giovanna	juana
cile	chile
realizzate	realizadas
individui	individuos
eddie	eddie
ettore	héctor
ettore	ettore
ceduto	cedido
emisfero	hemisferio
wikimedia	wikimedia
spagnoli	españoles
lavoratori	trabajadores
morta	muerta
progettazione	diseño
maschio	macho
maschio	varón
rappresentano	representan
sostituire	sustituir
sostituire	reemplace
nucleare	nuclear
fumo	humo
bellezza	belleza
terme	termas
indipendenti	independientes
disegnato	dibujado
confermato	confirmado
lupo	lobo
presidenza	presidencia
silva	silva
letteralmente	literalmente
bolla	bula
bolla	burbuja
coinvolto	implicado
coinvolto	involucrado
drammaturgo	dramaturgo
teorie	teorías
aggiunte	adiciones
vigore	vigor
finlandia	finlandia
ferito	herido
villaggi	aldeas
modificato	editado
modificato	modificado
esistenti	existentes
dicendo	diciendo
law	law
sviluppa	desarrolla
phil	phil
nino	nino
cambiamento	cambio
flusso	flujo
invito	invitación
columbia	columbia
editoriale	editorial
georges	georges
notevoli	notables
minuto	minuto
miglia	millas
pictures	pictures
grant	grant
situazioni	situaciones
book	book
dover	dover
novara	novara
cambiamenti	cambios
minor	minor
guy	guy
olimpico	olímpico
democrazia	democracia
professionale	profesional
scoprire	descubrir
miguel	miguel
indirizzo	dirección
indirizzo	direccion
strettamente	estrictamente
disc	disc
jerry	jerry
moda	moda
partendo	partiendo
richiede	requiere
etc	etc
ridurre	reducir
raymond	raymond
vite	tornillo
vite	vidas
vite	vid
fenomeni	fenómenos
zelanda	zelanda
prototipo	prototipo
hard	hard
rosario	rosario
presentazione	presentación
assalto	embestida
assalto	asalto
tante	tantas
professione	profesión
fermata	parada
deputati	diputados
staffetta	relevos
virus	virus
conquistare	conquistar
audio	audio
applicazioni	aplicaciones
carter	carter
junior	junior
server	servidor
server	servidores
bassista	bajista
carne	carne
norme	normas
cantata	cantada
pesci	piscis
pesci	pescados
pesci	peces
spero	espero
corrisponde	coincide
corrisponde	corresponde
esilio	exilio
esilio	destierro
lisa	lisa
version	version
criterio	criterio
sconosciuto	desconocido
rick	rick
robot	robot
robot	robots
apostolico	apostólico
bobby	bobby
momenti	momentos
stewart	stewart
saggista	ensayista
aragona	aragón
fiore	flor
sorpresa	sorpresa
costantino	constantino
circolo	circulo
promozionale	promocional
guidato	guiado
guidato	conducido
definire	definir
merci	mercancías
decorazioni	decoraciones
determinato	determinado
soldato	soldado
sintesi	síntesis
ispirazione	inspiración
conseguenze	consecuencias
terreni	terrenos
botanico	botánico
sostenere	apoyar
bay	bay
ridotta	reducida
chiude	cierra
astronomo	astrónomo
testimonianza	testimonio
celeste	celeste
stabilito	establecido
rimangono	permanecen
rimangono	quedan
acquisto	compra
woman	woman
assunta	assunta
assunta	contratada
was	was
type	type
sarah	sarah
calendario	calendario
barry	barry
ball	ball
potenti	potentes
potenti	poderosos
laterale	lateral
cresciuto	crecido
bit	bit
bit	pedacito
bit	bits
figlie	hijas
adattamento	adaptación
mitologia	mitología
herbert	herbert
riga	riga
piacenza	piacenza
grigio	gris
classici	clásicos
corto	corto
botswana	botswana
botswana	botsuana
bello	bello
bello	bonito
ricordato	recordado
bloccato	bloqueado
bloccato	atascado
pistola	pistola
nonno	abuelito
nonno	abuelo
forniti	proporcionados
forniti	suministrados
binari	binarios
queen	queen
norman	norman
colpa	culpa
perù	perú
fallimento	bancarrota
fallimento	fracaso
fallimento	quiebra
specifiche	especificaciones
tenore	tenor
fedele	fiel
taranto	taranto
taranto	tarento
pianura	llanura
pianura	llano
fornisce	provee
fornisce	proporciona
nelson	nelson
singola	individual
sudafrica	sudáfrica
sudafrica	suráfrica
misto	mixta
misto	mixto
atteggiamento	actitud
obiettivi	metas
obiettivi	objetivos
definitivo	definitivo
donato	donato
donato	donado
dichiarò	declaró
vapore	vapor
parker	parker
assistenza	asistencia
filo	alambre
filo	hilo
proteggere	proteger
conquistato	conquistado
capisco	comprendo
capisco	entiendo
ian	ian
cugino	primo
allievi	alumnos
tesoro	tesoro
tesoro	cariño
armati	armados
mba	mba
sponsor	patrocinadores
sponsor	patrocinador
scegliere	elegir
profondo	profundo
profondo	profunda
may	may
morgan	morgan
limitato	limitado
assumere	contratar
assumere	asumir
coppie	pares
coppie	parejas
ita	ita
paradiso	paraiso
paradiso	cielo
paradiso	paraíso
margine	margen
spettacoli	espectáculos
cronaca	crónica
light	light
citazione	cita
citazione	citación
citazione	cotización
deserto	desierto
raggiungendo	alcanzando
comico	cómico
comico	comediante
voglio	quiero
bizantino	bizantino
spese	gastos
accettare	aceptar
lavorazione	mecanizado
malattie	enfermedades
boys	boys
trattava	trataba
eseguita	ejecutada
atmosfera	atmósfera
cat	cat
catturato	capturado
gene	gene
lucca	lucca
formano	forman
corriere	mensajería
incendio	incendio
udine	udine
over	over
partigiano	partisano
pov	pov
terry	terry
probabilità	probabilidades
probabilità	probabilidad
girls	girls
colombo	colón
colombo	colombo
playstation	playstation
simboli	símbolos
raramente	raramente
bowl	bowl
abbandono	abandono
parlato	hablado
sostanze	sustancias
mosse	movimientos
concezione	concepción
dovevano	debían
eseguire	ejecute
positivo	positivo
decorazione	decoración
addestramento	entrenamiento
fiorentina	florentina
dovrebbero	deberían
scrittori	escritores
cattolici	católicos
prendendo	tomando
circolare	circular
pag	pag
hitler	hitler
arresto	detención
arresto	arresto
decidono	deciden
costruiti	construidos
organizzazioni	organizaciones
cross	cross
office	office
sorelle	hermanas
studiato	estudiado
completato	completado
neve	nieve
ruote	ruedas
asti	asti
ravenna	rávena
ravenna	ravenna
arts	arts
vaticano	vaticano
calibro	calibre
approccio	enfoque
stima	estimación
scienziato	científico
fire	fire
pazienti	pacientes
armato	armado
messaggi	mensajes
distruggere	destruir
staff	staff
marshall	marshall
uffici	oficinas
righe	filas
scultura	escultura
varese	varese
parlando	hablando
inferno	infierno
risoluzione	resolución
part	part
esponenti	exponentes
commenti	comentarios
saggi	sabios
freddo	frío
stanley	stanley
pino	pino
onde	olas
onde	ondas
das	das
dea	dea
dea	diosa
dario	dario
dario	darío
avversari	oponentes
avversari	adversarios
avversari	opositores
dipende	depende
party	party
pareggio	empate
femmina	hembra
lloyd	lloyd
bruxelles	bruselas
moon	moon
budapest	budapest
aviazione	aviacion
aviazione	aviación
fort	fort
ballo	baile
necessari	necesarios
larry	larry
puglia	puglia
puglia	apulia
adottato	adoptado
finito	terminado
inaugurato	inaugurado
motivazioni	motivaciones
pubblicità	publicidad
impegnato	comprometido
demo	demo
more	more
occupato	ocupado
mito	mito
testimonianze	testimonios
marine	marines
marine	marine
radici	raíces
ella	ella
bolzano	bolzano
creando	creando
jay	jay
vietnam	vietnam
diavolo	diablo
tommy	tommy
seguita	seguida
round	round
colombia	colombia
dichiarazione	declaración
georgia	georgia
rowspan	rowspan
esperti	expertos
ampiamente	extensamente
ampiamente	ampliamente
lombardo	lombardo
dispone	dispone
ann	ann
parlamentare	parlamentario
signori	caballeros
signori	señores
ginevra	ginebra
serbo	serbio
settecento	setecientos
difendere	defender
god	god
denti	dientes
equilibrio	equilibrio
continente	continente
tipicamente	típicamente
attribuito	atribuido
side	side
iniziare	empezar
iniziare	comenzar
archeologico	arqueológico
critici	críticos
luisa	luisa
veicolo	vehículo
insetti	insectos
isabella	isabella
sviluppare	desarrollar
discutere	discutir
medie	promedios
duo	duo
lawrence	lawrence
cristianesimo	cristiandad
cristianesimo	cristianismo
costumi	disfraces
costumi	trajes
calciatori	futbolistas
visibili	visibles
times	times
patriota	patriota
venerdì	viernes
sviluppata	desarrollada
episcopale	episcopal
gallo	galo
gallo	gallo
accompagnato	acompañado
messicano	mexicana
messicano	mexicano
celebri	célebres
celebri	celebre
richiesto	solicitado
richiesto	requerido
mail	mail
stuart	estuardo
stuart	stuart
familiare	familiar
scudo	escudo
precisione	precisión
precisione	exactitud
vedova	viuda
vedova	widow
curva	curva
scaduto	caducado
scaduto	vencido
scaduto	expirado
manchester	manchester
marche	marche
marche	marcas
minima	mínima
get	get
memorie	memorias
russi	rusos
mariano	mariano
gonzaga	gonzaga
operato	operado
visconti	visconti
when	when
meccanismo	mecanismo
esteri	ésteres
pagamento	pago
todd	todd
profonda	profunda
lost	lost
testamento	albedrío
testamento	testamento
ricevere	recibir
paesaggio	paisaje
gonzález	gonzález
roman	roman
dirige	dirige
tracciato	trazado
produzioni	producciones
potenziale	potencial
usate	usadas
ibn	ibn
anton	anton
anton	antón
soluzioni	soluciones
cena	cena
sebastiano	sebastián
rurale	rural
devo	debo
viaggi	viajes
ospiti	huéspedes
ospiti	invitados
giornate	jornadas
distrutta	destruida
volley	volley
eretta	erguida
entertainment	entertainment
ebraico	hebreo
musei	museos
lire	liras
wilhelm	wilhelm
coscienza	consciencia
coscienza	conciencia
movie	movie
alfa	alfa
siracusa	siracusa
tipici	típicos
baia	bahía
blocchi	bloques
produttori	productores
produttori	fabricantes
aosta	aosta
traguardo	meta
interessato	interesado
country	country
tito	tito
nfl	nfl
attaccare	atacar
frammenti	fragmentos
spirituale	espiritual
centrali	centrales
monaci	monjes
superato	superado
gusto	gusto
erba	césped
erba	hierba
age	age
convocato	convocado
apparentemente	aparentemente
frazioni	fracciones
metallo	metal
pone	plantea
raggi	rayos
tende	cortinas
sottospecie	subespecies
sottospecie	subespecie
raggruppa	agrupa
raggruppa	agrupar
lecce	lecce
infortunio	lesión
dottrina	doctrina
arrivano	vienen
arrivano	llegan
microsoft	microsoft
denis	denis
dream	dream
offensiva	ofensiva
benjamin	benjamin
benjamin	benjamín
finestre	ventanas
fattore	factor
fumetto	historieta
fumetto	cómic
permettono	permiten
barocco	barroco
pronto	listo
marvel	marvel
adulti	adultos
adulti	adulto
decidere	decidir
anonimo	anónimo
danny	danny
parametri	parámetros
iniziano	empiezan
iniziano	comienzan
recita	recita
grazia	gracia
grazia	grazia
gay	gays
gay	gay
armando	armando
journal	journal
finestra	ventana
finestra	ventanillas
undici	once
estrema	extrema
editori	editores
eredità	legado
eredità	herencia
considera	considera
funzionamento	funcionamiento
paziente	paciente
dramma	drama
ron	ron
fotografo	fotógrafo
permanente	permanente
corretta	correcta
corretta	corregida
broadway	broadway
sostenuto	sostenido
cannone	cañón
palazzi	palacios
lezioni	lecciones
rotta	rumbo
videoclip	videoclips
videoclip	videoclip
camillo	camillo
camillo	camilo
serra	invernadero
serra	serra
rimasero	permanecieron
rimasero	quedaron
residenti	residentes
ministri	ministros
accedere	acceder
studios	studios
dottore	doctor
passaggi	pasos
dragon	dragon
risalgono	remontan
domande	preguntas
miami	miami
culture	culture
culture	culturas
fossili	fósiles
monza	monza
franchi	francos
opportunità	oportunidad
opportunità	oportunidades
automobilistico	automotor
eroi	héroes
reno	rin
reno	reno
uova	huevos
dimostrare	demostrar
sostituita	sustituida
name	name
estremo	extrema
estremo	extremo
rappresentare	representar
taglio	corte
fondatori	fundadores
arabi	arabes
arabi	árabes
perdendo	perdiendo
harris	harris
convenzione	convención
convenzione	convenio
emma	emma
jon	jon
track	track
wright	wright
union	union
sportivi	deportistas
giunti	empalmes
vetta	cima
mettendo	poniendo
mettendo	colocando
calore	calor
cratere	cráter
cooper	cooper
perfettamente	perfectamente
libretto	libreto
collo	cuello
buoni	cupones
buoni	buenos
rotazione	rotar
rotazione	rotación
settori	sectores
soprano	soprano
soprano	sopranos
albanese	albanés
popolarità	popularidad
logica	lógica
grotta	gruta
grotta	cueva
grotta	cuevas
giocando	jugando
commons	commons
monica	monica
monica	mónica
let	let
economici	baratos
economici	económicos
valida	válida
murray	murray
moderne	modernas
dino	dino
draft	draft
viva	viva
indicata	indicado
indicata	indicada
borbone	borbón
canton	canton
costruite	construidas
teologia	teología
nate	nate
antichità	antigüedad
chiudere	cerrar
walker	walker
consumo	consumo
satellite	satélite
valido	válido
farà	hará
rimini	rimini
rimini	rímini
martina	martina
novità	novedad
novità	novedades
percentuale	porcentaje
mussolini	mussolini
css	css
opposto	opuesto
fantasma	fantasma
greg	greg
assist	asistencias
compiti	tareas
warner	warner
pietre	piedras
spezia	especia
ascolti	escuche
municipio	ayuntamiento
malta	mortero
malta	malta
valli	valles
volontari	voluntarios
rispondere	contestar
rispondere	responder
temperature	temperaturas
mtv	mtv
patriarca	patriarca
parentesi	paréntesis
scavi	excavación
scavi	excavaciones
donald	donald
dialogo	diálogo
polacca	polaca
pubblicate	publicadas
second	second
vladimir	vladímir
vladimir	vladimir
esploratore	exploradora
esploratore	explorador
coalizione	coalición
suore	monjas
cinesi	chinos
maschera	máscara
maschera	mascara
classificato	clasificado
condanna	condena
genio	genio
genio	genialidad
galles	gales
matrice	matriz
inclusa	incluida
dettaglio	detalle
legione	legión
dean	dean
calcolo	cálculo
mostro	monstruo
ribelli	rebeldes
dispositivo	dispositivo
associato	asociado
gravemente	gravemente
austin	austin
liquido	líquido
stefan	stefan
massiccio	macizo
costruzioni	construcciones
sperimentale	experimental
territoriale	territorial
campbell	campbell
salita	subida
regolamento	reglamento
margaret	margaret
amato	amado
feudo	feudo
rizzoli	rizzoli
assassino	asesino
radicale	radical
decine	decenas
mac	mac
dotati	dotados
dotati	dotadas
notato	notado
capitoli	capítulos
spiaggia	playa
rosse	rojas
aka	aka
informatica	informática
flora	flora
nobiltà	nobleza
divina	divina
omaggio	homenaje
ruota	rotar
ruota	rueda
castiglia	castilla
tessuto	tejido
nascosto	ocultado
nascosto	escondido
nascosto	ocultos
nascosto	oculto
sentimenti	sentimientos
vetro	cristal
vetro	vidrio
soul	soul
giornali	periódicos
verificare	verificar
verificare	comprobar
fifa	fifa
privati	privadas
privati	privados
privati	particulares
occupata	ocupada
giardini	jardines
dna	adn
affermazione	afirmación
renzo	renzo
appaiono	aparecen
ring	ring
georg	georg
valerio	valerio
debole	débil
mistero	misterio
maresciallo	mariscal
newton	newton
revisione	revisión
palla	bola
palla	balón
palla	pelota
how	how
sessione	sesión
messi	messi
salvezza	salvación
garantire	garantizar
individuo	individuo
variazioni	variaciones
feriti	heridos
uccisi	asesinados
democratica	democrática
studente	alumno
studente	estudiante
astenuti	abstenciones
discipline	disciplinas
podio	podio
trazione	tracción
carabinieri	carabineros
carabinieri	carabinieri
verifica	verificación
verifica	verificar
verifica	comprobación
litri	litros
quaranta	quaranta
quaranta	cuarenta
graham	graham
people	people
comparsa	aparición
rené	rené
magazine	magazine
sfera	esfera
profondamente	profundamente
sara	sara
milita	milita
nati	nacidos
valutare	evaluar
impedire	impedir
raccogliere	recopilar
raccogliere	cosechar
raccogliere	recoger
efficace	eficaz
efficace	efectiva
single	soltero
single	solteras
svolgere	desempeñar
andando	yendo
ama	ama
disambigua	desambiguación
porzione	porción
bianche	blancas
diana	diana
bbc	bbc
mancano	faltan
rivale	rival
cupola	cúpula
prossimo	próximo
prossimo	siguiente
airlines	airlines
accusato	acusado
principato	principado
action	action
orlando	orlando
ralph	ralph
segnalare	denunciar
segnalare	reportar
liberi	libere
liberi	libres
ambasciatore	embajador
accordi	acordes
accordi	acuerdos
platino	platino
contribuito	contribuido
partecipano	participan
filippine	filipinas
toronto	toronto
pseudonimo	seudónimo
pseudonimo	pseudónimo
ppa	ppa
automaticamente	automáticamente
sbagliato	equivocado
sbagliato	mal
fascismo	fascismo
pagare	pagar
nuoto	natación
angela	angela
angela	ángela
osservazioni	observaciones
cattura	captura
place	place
zampe	patas
four	four
archeologici	arqueológicos
archeologici	arqueológicas
neil	neil
attraversa	atraviesa
attraversa	cruza
billboard	billboard
equivalente	equivalente
appartenenza	pertenencia
lorena	lorena
artificiale	artificial
scorta	escolta
orientamento	directriz
orientamento	orientación
guide	guías
caduti	caídos
sovrani	soberanos
dibattito	debate
esplosione	explosión
jersey	jersey
promuovere	promover
geografica	geográfica
elio	helio
elio	elio
economista	economista
sindrome	síndrome
youtube	youtube
just	just
europe	europe
dimissioni	dimisión
quartieri	barrios
gianfranco	gianfranco
asburgo	habsburgo
trattati	tratados
seminario	seminario
dichiara	declara
rami	ramas
rami	rami
rifiuta	rechaza
fonda	fonda
ospitare	recibimiento
achille	achille
achille	aquiles
viale	avenida
collabora	colabora
gioventù	juventud
lettore	reproductor
lettore	lector
composizioni	comps
composizioni	composiciones
now	now
acustica	acústica
nazista	nazi
coraggio	coraje
coraggio	valentía
settima	séptima
nova	nova
casale	casale
cattivo	malo
cattivo	travieso
parenti	parientes
science	science
chan	chan
lanciato	lanzado
mostrato	mostrado
pozzo	pozo
aggiunge	añade
diario	diario
crescente	creciente
buono	bueno
integrale	integral
legislatura	legislatura
arnold	arnold
forum	foros
three	three
dennis	dennis
perduto	perdido
trio	trio
trio	trío
separazione	separación
seguono	siguen
spiegare	explicar
spiegare	explique
considerando	considerando
serbia	serbia
dilettanti	amateurs
dilettanti	aficionados
ottenuta	obtenida
gestire	manejar
gestire	gestionar
gestire	administrar
beato	bienaventurado
beato	beato
guarda	mira
sandro	sandro
essenzialmente	esencialmente
cade	cade
cade	cae
sentire	sentir
carro	carreta
tue	tue
derby	derby
formati	formatos
contessa	condesa
abito	traje
sentenza	sentencia
professionisti	profesionales
tonnellate	toneladas
alimentazione	alimentación
ted	ted
mercedes	mercedes
delta	delta
piace	gusta
cancellato	cancelado
cancellato	borrado
colonie	colonias
only	only
provare	pruebe
provare	probar
provare	intentar
batman	batman
claudia	claudia
neo	neo
creature	criaturas
futura	futura
arturo	arturo
comprendere	comprender
ernst	ernst
marcel	marcel
organizzare	organizar
inaugurata	inaugurada
trasformato	transformado
veri	verdaderos
veri	reales
martín	martín
chiamate	llamadas
anniversario	aniversario
perry	perry
piacere	gustar
piacere	placer
wwe	wwe
lavorando	trabajando
contatti	contactos
silenzio	silencio
bilancio	presupuesto
premier	premier
vicario	vicario
sceriffo	alguacil
sceriffo	sheriff
conquistò	conquistó
bobina	carrete
bobina	bobina
riconosciuta	reconocida
ottavo	octavo
credere	creer
campania	campania
stretta	estrecha
alessio	alejo
arcipelago	archipiélago
blood	blood
poveri	pobres
salva	guardar
maddalena	maddalena
maddalena	magdalena
tecnologie	tecnologías
usano	usan
usano	utilizan
prossima	próxima
affermato	afirmado
tappe	hitos
tappe	etapas
rodolfo	rodolfo
croato	croata
busto	busto
parziali	parciales
nintendo	nintendo
palma	palma
supercoppa	supercopa
negozio	tienda
colleghi	colegas
verticale	vertical
autonomo	autónomo
extra	extras
extra	extra
page	page
cremona	cremona
jacopo	jacopo
prodotte	producidas
terzi	terceros
spinta	alza
spinta	empuje
calci	patadas
strano	extraño
strano	raro
infrastrutture	infraestructura
infrastrutture	infraestructuras
terapia	terapia
pete	pete
janeiro	janeiro
guerrieri	guerreros
feste	fiestas
insegna	enseña
registrazioni	grabaciones
luke	luke
schiavi	esclavos
prigioniero	preso
prigioniero	prisionero
amministratori	administradores
point	point
harold	harold
curiosità	curiosidad
curiosità	curiosidades
robinson	robinson
ambientato	ambientado
ambientato	ambientada
matthew	mathew
radar	radar
trasmissioni	transmisiones
complessi	complejos
dedica	dedica
dedica	dedicatoria
penale	penal
guinea	guinea
baker	baker
visti	vistos
visti	visados
visti	visas
tragedia	tragedia
alternative	alternativas
registrati	registrarse
conobbe	conoció
cadere	caer
books	books
ottavi	octavos
leggero	ligero
consecutive	consecutivas
dallas	dallas
mitchell	mitchell
mitchell	mitchel
marte	marte
sconfiggere	derrotar
den	den
monumentale	monumental
colin	colin
psicologia	psicología
preliminare	preliminar
vaglio	tamiz
heinrich	heinrich
attivi	activos
cinquecento	cinquecento
cinquecento	quinientos
presero	tomaron
milione	millón
negativo	negativa
negativo	negativo
rally	rally
perfetto	perfecto
borsa	bolso
borsa	bolsa
mie	mías
considerate	consideradas
army	army
declino	declive
declino	declinación
specifici	específicos
patrono	patrono
ispettore	inspector
strategia	estrategia
conservata	conservada
normali	normales
fidanzata	novia
fidanzata	prometida
uccello	ave
uccello	pájaro
flavio	flavio
intensità	intensidades
intensità	intensidad
discografia	discografía
deposito	depósito
salone	salón
aleksandr	aleksandr
core	core
appello	súplica
appello	apelar
appello	apelación
appello	llamamiento
jugoslavia	yugoslavia
mantenendo	manteniendo
braccia	brazos
abside	ábside
venere	venus
creò	creó
tempesta	tormenta
tempesta	tempestad
brillante	brillante
battle	battle
adige	adigio
adige	adige
proseguire	proseguir
proseguire	continuar
pala	pala
insediamenti	asentamientos
annuncia	anuncia
apparso	apareció
trentino	trentino
buone	buenas
trasferirsi	mudarse
never	never
quindici	quince
pat	pat
pioggia	lluvia
caldo	caliente
straniero	forastero
straniero	extranjero
stagionale	estacional
teorema	teorema
zurigo	zúrich
zurigo	zurich
panchina	banca
panchina	banco
pubblicare	publicar
citare	citar
citare	mencionar
citare	demandar
turchi	turcos
impiegati	empleados
days	days
volere	querer
croazia	croacia
mari	mari
corti	cortos
corti	corto
processione	procesión
fiorentino	fiorentino
fiorentino	florentino
determinare	determinar
determinare	determine
anelli	anillos
anelli	anillas
tendenza	tendencia
usi	usos
autostrada	autopista
affronta	aborda
affronta	enfrenta
magistrato	magistrado
bot	bots
bot	bot
ponti	puentes
equazione	ecuación
rita	rita
canta	canta
causato	causado
divide	divide
massimiliano	maximiliano
apollo	apolo
apollo	apollo
silver	silver
regolarmente	regularmente
flauto	flauta
bibbia	biblia
ludwig	ludwig
forlì	forlì
forlì	forli
thompson	thompson
contadini	granjeros
contadini	campesinos
strato	capa
rottura	ruptura
rottura	rotura
binario	binario
cortile	patio
aggiornate	actualizadas
giordano	jordán
giordano	giordano
have	have
project	project
griffith	griffith
avvento	adviento
avvento	advenimiento
inclusi	incluidos
inclusi	incluídos
necessarie	necesarias
ecclesiastica	eclesiástica
inseriti	insertados
magno	magno
costume	disfraz
sentiero	sendero
frasi	frases
cervello	cerebro
animata	animada
inseguimento	persecución
stabilimento	establecimiento
necessariamente	necesariamente
spostamento	desplazamiento
grandezza	grandeza
grandezza	magnitud
concesso	concedida
concesso	concedido
preciso	preciso
abruzzo	abruzos
abruzzo	abruzzo
attribuita	atribuida
attribuita	atribuido
archeologo	arqueólogo
fila	fila
peccato	pecado
peccato	lástima
descritta	descrita
caratteristico	característico
citazioni	cotizaciones
valley	valley
organismo	organismo
ritirarsi	retirarse
dite	digan
dite	decís
esecutivo	ejecutivo
hunter	hunter
genovese	genovese
registrare	registrar
registrare	grabar
boris	boris
boris	borís
linguistica	lingüística
nastro	cinta
ritornare	volver
esperimenti	experimentos
proprietari	propietarios
proprietari	dueños
info	info
latte	leche
biennale	bienal
conoscenze	conocimientos
albania	albania
pechino	pekín
pechino	beijing
urbana	urbana
pescara	pescara
iran	irán
raccolti	cosechas
raccolti	recogidos
messe	misas
delitto	crimen
delitto	delito
diploma	diploma
joan	joan
conversione	conversión
immaginario	imaginaria
immaginario	imaginario
pensato	pensado
parlano	hablan
annullata	anulada
annullata	cancelada
stavano	estaban
augusta	augsburgo
augusta	augusta
serena	serena
costretti	obligados
rientro	reingreso
intervenire	intervenir
dedicati	dedicados
ottava	octava
costituzionale	constitucional
provato	intentado
provato	probado
ospitato	alojado
ospitato	hospedado
partner	socios
partner	socio
fiera	feria
telaio	bastidor
telaio	chasis
verranno	vendrán
viaggiatori	viajeros
apparizioni	apariciones
discendenti	descendientes
andreas	andreas
dico	digo
abbandonata	abandonada
ristrutturazione	reestructuración
decisero	decidieron
secret	secret
secondaria	secundaria
rilevanti	relevantes
particelle	partículas
regni	reinos
antoine	antoine
anziano	anciano
rimanendo	permaneciendo
field	field
sogni	sueños
consigli	consejos
apostolica	apostólica
guerriero	guerrero
indicano	indican
siria	siria
jacob	jacob
concluso	concluido
sottile	sutil
sottile	delgado
sottile	delgada
istituti	institutos
collegato	vinculado
collegato	conectado
bombardamento	bombardeo
contenere	contener
averlo	tenerlo
rigore	penalti
rigore	rigor
permettendo	permitiendo
slam	slam
julie	julie
sacco	saco
istruzioni	instrucciones
alleato	aliado
mobili	muebles
esprimere	expresar
hip	hip
hip	eep
contengono	contienen
she	she
traduttore	traductor
rivelato	revelado
accuse	cargos
accuse	acusaciones
summer	summer
dorso	dorso
dorso	lomo
preferito	preferido
preferito	favorito
preferito	favorita
osservare	observar
touchdown	touchdown
repertorio	repertorio
detroit	detroit
ritmo	ritmo
iniziali	iniciales
comunicazioni	comunicaciones
collaborare	colaborar
lugano	lugano
avrei	tendría
corrispondenti	corresponsales
corrispondenti	correspondientes
inventore	inventor
japan	japan
prosa	prosa
prendono	toman
formale	formal
stoccolma	estocolmo
simpson	simpson
kennedy	kennedy
australiana	australiana
prussia	prusia
appartengono	pertenecen
persa	perdida
restare	quedarme
leonard	leonard
ottenuti	obtenidos
dispositivi	dispositivos
statuto	estatuto
statuto	estatutos
miglioramento	mejoramiento
miglioramento	mejora
cadenza	cadencia
rivoluzionario	revolucionario
scacchi	ajedrez
consegna	entrega
formalmente	formalmente
amedeo	amedeo
amedeo	amadeo
qualificata	cualificada
qualificata	calificada
missili	misiles
soprannome	apodo
take	take
derivato	derivado
vitale	vitale
vitale	vital
talento	talento
stop	stop
operare	operar
liguria	liguria
varsavia	varsovia
marocco	marruecos
compagna	compañera
preghiera	plegaria
preghiera	oración
interprete	intérprete
primarie	primarias
conflitti	conflictos
business	business
autorizzazione	autorización
iniziative	iniciativas
evans	evans
riproduzione	reproducción
completata	completada
completata	completado
there	there
striscia	franja
striscia	tira
striscia	franjas
nudo	desnudo
nudo	desnuda
integrazione	integración
pane	pan
sensi	sentidos
ossa	huesos
altrettanto	igualmente
laureato	graduado
laureato	licenciado
possedeva	poseía
mini	mini
pittori	pintores
kate	kate
parrocchie	parroquias
allenatori	entrenadores
nuclei	núcleos
duro	duro
unisce	une
head	head
dos	dos
esteso	ampliado
esteso	extendido
houston	houston
compone	compone
rob	rob
dedicate	dedicadas
amichevole	amistosa
amichevole	amigable
amichevole	amistoso
emergenza	emergencia
susan	susan
suona	suena
ottomano	otomano
amy	amy
pomeriggio	tarde
distinzione	distinción
jennifer	jennifer
cadde	cayó
mayer	mayer
riferirsi	referir
riferirsi	referirse
potter	potter
dedicarsi	dedicarse
nancy	nancy
indicazioni	indicaciones
droga	droga
iraq	irak
iraq	iraq
cammino	camino
liberale	liberal
foggia	foggia
piatto	plato
sedi	sedes
doppiaggio	doblaje
mostrano	muestran
sapore	sabor
utilizzano	utilizan
prospettiva	perspectiva
redazione	redacción
sean	sean
opinioni	opiniones
piemontese	piemontese
atlantico	atlántico
leopoldo	leopoldo
continentale	continental
cuba	cuba
correnti	corrientes
cella	celda
permanenza	permanencia
completare	completar
modificata	modificada
procedere	proceder
qualificato	cualificado
qualificato	calificado
caro	querido
mulino	molino
religioni	religiones
century	century
collection	collection
adatto	apto
adatto	adecuado
funziona	funciona
mantiene	mantiene
pronuncia	pronunciación
palio	palio
her	her
future	futuras
parametro	parámetro
martini	martini
martini	martinis
destinati	destinados
ricchi	ricos
manutenzione	mantenimiento
pratiche	prácticas
riconoscere	reconocer
significativo	significativo
justin	justin
about	about
debuttato	debutó
concentrazione	concentración
mamma	mamá
mamma	mama
mamma	mami
chuck	chuck
sassofono	saxofón
mira	apunta
gioia	alegría
locomotive	locomotoras
betty	betty
specchio	espejo
utilità	utilidades
utilità	utilidad
warren	warren
soppresso	suprimido
lineare	lineal
positiva	positiva
cittadinanza	ciudadanía
trovavano	encontraban
assegnata	asignada
collins	collins
rame	cobre
pianeti	planetas
kurt	kurt
accreditato	acreditado
includono	incluyen
prolungata	prolongada
card	card
bulgaria	bulgaria
fucile	fusil
fucile	escopeta
fucile	rifle
settimanale	semanal
falso	falso
prince	prince
social	sociales
social	social
carmine	carmine
cattedra	cátedra
frutti	frutos
supera	supera
difese	defensas
riprendere	reanudar
telespettatori	telespectadores
registrata	registrada
risposte	respuestas
dylan	dylan
promessa	promesa
quanti	cuántos
tentato	intentado
tentato	tentado
facevano	hacían
discendente	plumón
discendente	descendiente
discendente	descendente
concetti	conceptos
decisioni	decisiones
sec	sec
delegazione	delegación
reazioni	reacciones
farina	harina
telefono	teléfono
tredici	trece
arezzo	arezzo
racing	racing
rimbalzi	rebotes
trasformata	transformada
lisbona	lisboa
assente	ausente
disegnatore	dibujante
apple	apple
keith	keith
doc	doc
scoperte	descubrimientos
segnalato	denunciado
segnalato	divulgado
segnalato	reportado
attentato	atentado
port	port
pugile	boxeador
amburgo	hamburgo
convincere	convencer
autobus	autobús
autobus	autobuses
coperto	cubierto
organizza	organice
organizza	organizar
organizza	organiza
confusione	confusión
fai	haces
cantanti	cantantes
candidati	candidatos
kansas	kansas
grosseto	grosseto
stars	stars
adozione	adopción
trent	trent
vicepresidente	vicepresidente
vicepresidente	vicepresidenta
vogliono	quieren
fermare	detener
registi	cineastas
promossa	promovida
bagno	baño
scherma	esgrima
padrone	amo
guardie	guardias
fornito	proporcionado
fornito	suministrado
ruggero	ruggero
dir	dir
vecchie	antiguas
vecchie	viejas
automobile	automóvil
concorrenti	concursantes
concorrenti	competidores
nodi	nudos
nodi	nodos
storicamente	históricamente
schede	pestañas
download	descargas
beatrice	beatrice
beatrice	beatriz
tradizionalmente	tradicionalmente
estesa	extendida
velocemente	rápidamente
assegnati	asignados
cresce	crece
caffè	cafés
caffè	café
giurisprudenza	jurisprudencia
bonaparte	bonaparte
wolf	wolf
potenze	potencias
conduttrice	presentadora
ossigeno	oxigeno
ossigeno	oxígeno
strategica	estratégica
variabili	variables
raggiunta	alcanzada
raggiunta	conseguida
raggiunta	alcanzado
nizza	niza
carbonio	carbono
agire	actuar
attaccato	atacado
edwards	edwards
canna	caña
alfabeto	alfabeto
esposto	expuesto
indicazione	indicación
seicento	seiscientos
seicento	seicento
lione	lyon
helen	helen
eliminata	eliminada
integrare	integrar
inserite	insertadas
gamba	pierna
montaggio	montaje
continuità	continuidad
cifra	cifra
cifra	dígito
islam	islam
inc	inc
attivista	activista
creatura	criatura
vestito	alineada
vestito	vestido
blake	blake
pietà	piedad
ercole	hércules
apparire	aparecer
minerale	mineral
austro	austro
partì	partió
approvazione	aprobación
cronache	crónicas
austriaci	austriacos
polvere	polvo
model	model
franklin	franklin
nicolò	nicolo
nicolò	nicolò
policy	policy
trasforma	transforma
sony	sony
partecipando	participando
colpisce	golpea
mago	mago
mago	hechicero
luci	luces
galassia	galaxia
cani	perros
primato	primacía
destinazione	destino
anteriori	delanteras
harrison	harrison
apice	ápice
guidati	guiados
dialetti	dialectos
combinazione	combinación
compaiono	aparecen
magic	magic
obbligo	obligación
frequentato	frecuentado
gianluca	gianluca
sculture	esculturas
restano	permanecen
restano	quedan
blog	blog
blog	blogs
cronometro	cronómetro
cronometro	contrarreloj
proteine	proteínas
venezuela	venezuela
pose	poses
charlotte	charlotte
congo	congo
decimo	décimo
ram	ram
prefetto	prefecto
domani	mañana
emittente	emisora
emittente	emisor
trasformazioni	transformaciones
studioso	erudito
studioso	estudioso
operatore	operador
scioglimento	disolución
roland	roland
farmaci	medicaciones
parallelo	paralelo
assassinio	asesinato
supremo	supremo
rinascimento	renacimiento
inno	himno
andrej	andréi
giudici	jueces
sat	sat
major	major
classic	classic
linda	linda
fisso	fijo
giuria	jurado
eredi	herederos
roll	roll
olivier	olivier
voli	vuelos
strega	bruja
serio	serio
eccetto	excepto
presentare	presentar
normandia	normandía
benevento	benevento
collegata	conectada
vere	verdaderas
tradimento	traición
spiegato	explicado
spiegato	explicó
aumenta	aumenta
aumenta	aumentar
maglie	camisetas
maglie	mallas
brasiliana	brasileña
innamorato	enamorado
rinascimentale	renacentista
scomparso	desaparecido
correttamente	correctamente
franca	franca
demone	demonio
entrando	entrando
scale	escaleras
scale	escalas
grano	grano
delegato	delegado
fernández	fernández
earth	earth
servono	sirven
pastore	pastor
bernardino	bernardino
inediti	inéditos
designer	diseñador
fidanzato	novio
turner	turner
farmaco	medicación
asta	subasta
asta	asta
cerchio	círculo
volante	volante
sabbia	arena
spencer	spencer
modulo	módulo
modulo	formulario
clinica	clínica
cellulare	celular
khan	khan
khan	kan
scandalo	escándalo
sintomi	síntomas
dintorni	alrededores
url	url
url	urls
annata	vendimia
tipologie	tipologías
scoprì	descubrió
capienza	aforo
flash	flash
express	express
progressivamente	progresivamente
decorato	condecorado
decorato	adornado
meridionali	meridionales
pennsylvania	pennsylvania
pennsylvania	pensilvania
rumeno	rumano
carmen	carmen
svolgono	desempeñan
spareggio	desempate
goffredo	godofredo
wood	wood
giurisdizione	jurisdicción
spiegazione	explicación
sbarco	desembarco
sbarco	desembarque
caroline	caroline
tromba	trompeta
trapani	taladros
trapani	trapani
unici	únicos
composte	compuestas
intelligenza	inteligencia
lunedì	lunes
johan	johan
testata	ojiva
testata	cabezazo
giusta	justa
ricci	rizos
ricci	erizos
ricci	ricci
sovietici	soviéticos
stan	stan
aggiungo	añado
aggiungo	agrego
esperimento	experimento
annullare	anular
annullare	abortar
ballerina	bailarina
siciliana	siciliana
impegnati	comprometidos
ordinamento	ordenación
ordinamento	ordenamiento
brad	brad
accettato	aceptado
cuneo	cuña
cuneo	cuneo
orecchie	orejas
orecchie	oídos
apparve	apareció
roberts	roberts
preda	presa
grafico	gráfico
atlanta	atlanta
radice	raíz
giornalisti	periodistas
avvio	arranque
belgrado	belgrado
sposata	casada
cominciarono	empezaron
cominciarono	comenzaron
savona	savona
heavy	heavy
osservatorio	observatorio
alpina	alpina
influenze	influencias
complessa	compleja
notorietà	notoriedad
prefazione	prefacio
prefazione	prólogo
propaganda	propaganda
odio	odio
circolazione	circulación
christmas	christmas
influenzato	influido
influenzato	influenciado
sembrava	parecía
ricchezza	riquezas
ricchezza	riqueza
rifiuto	rechazo
hills	hills
deep	deep
domini	dominios
liverpool	liverpool
frati	frailes
precisa	precisa
gestito	gestionado
net	net
fotografie	fotografías
panni	paños
suoni	sonidos
venduti	vendidos
venduti	vendidas
continui	continúe
marini	marini
riconosce	reconoce
iron	iron
capocannoniere	goleador
musulmani	musulmanes
convince	convence
servita	servido
arcangelo	arcángel
quadrato	cuadrado
riunione	reunión
shakespeare	shakespeare
mafia	mafia
crocifisso	crucifijo
crocifisso	crucificado
sforzi	esfuerzos
netto	neto
conservati	preservados
conservati	conservados
erik	erik
sforzo	esfuerzo
mostri	monstruos
sufficienti	suficientes
distingue	distingue
scienziati	científicos
recensione	reseña
nobel	nobel
craig	craig
kid	kid
addio	adiós
eleonora	eleonora
eleonora	leonor
crescere	crecer
pavel	pavel
pavel	pável
vegetazione	vegetación
mantenuto	mantenido
lincoln	lincoln
brindisi	brindis
brindisi	brindisi
armenia	armenia
pistoia	pistoia
primaria	primaria
creati	creados
distinti	distinguidos
act	act
codici	códigos
costantemente	constantemente
pellegrini	pellegrini
pellegrini	peregrinos
sostenitori	partidarios
sostenitori	simpatizantes
poeti	poetas
kent	kent
intenso	intenso
comandi	comandos
inesistenti	inexistentes
ottica	óptica
accettò	aceptó
liberamente	libremente
baden	baden
propose	propuso
visibilità	visibilidad
distante	distante
management	management
salvato	salvado
salvato	guardado
contemporanei	contemporáneos
libreria	librería
drammatica	dramática
fantasia	fantasía
pilastri	pilares
peli	vello
civico	cívico
gotico	gótico
ward	ward
coordinate	coordenadas
disputate	disputadas
interessanti	interesantes
dieta	dieta
gustavo	gustavo
copenaghen	copenhague
cairo	cairo
proporre	proponer
rovine	ruinas
centre	centre
cercano	buscan
other	other
documentazione	documentación
hermann	hermann
cap	cap
cap	capi
chitarre	guitarras
dorsale	dorsal
tavolo	mesa
raccolto	cosecha
vinci	vinci
indicati	indicados
nonna	abuela
nonna	abuelita
justice	justice
bulgaro	búlgaro
nicole	nicole
anglo	anglo
associata	asociada
dipendente	dependiente
dominante	dominante
honda	honda
comportamenti	comportamientos
criminali	criminales
criminali	delincuentes
trovata	encontrada
vela	vela
imponente	imponente
sondaggio	encuesta
sondaggio	sondeo
moro	moro
esponente	exponente
grace	grace
aiutato	ayudado
alo	alo
beta	beta
gennaro	gennaro
spostato	movido
spostato	desplazado
valentino	valentín
valentino	valentino
liberare	liberar
wolfgang	wolfgang
create	create
create	creadas
