พุง	belly
พุง	gut
นามแฝง	alias
นามแฝง	aliases
นามแฝง	pseudonym
ตะกร้า	basket
ตะกร้า	cart
คีธ	keith
das	das
ฟองน้ำ	sponge
สะดือ	navel
สะดือ	belly
atm	atm
คอด	cod
ห่วย	suck
ห่วย	sucks
สวิง	swing
aux	aux
jane	jane
ลูกโป่ง	balloon
ใต้ถุน	basement
สแปม	spam
ccd	ccd
ปราง	prague
แฟลต	flat
เจี๊ยบ	chick
เจี๊ยบ	chicken
เจี๊ยบ	gumbo
kimi	kimi
tostring	tostring
arc	arc
ตะขาบ	centipede
ทำแท้ง	abortion
ทำแท้ง	abortions
ลูกเกด	raisins
แตกหัก	broken
แตกหัก	fracture
ไดอาน่า	diana
โทรสาร	fax
ละเว้น	ignored
ละเว้น	omit
ค่าแรง	wage
ค่าแรง	wages
koi	koi
คร่อม	straddle
ลิงค์	link
โฮป	hope
bachelor	bachelor
lb	lb
สวิสเซอร์แลนด์	switzerland
อัตตา	ego
เครื่องปั้นดินเผา	pottery
clip	clip
หวย	raffle
เคิร์ด	kurdish
pr	pr
ann	ann
แออัด	congestion
แออัด	slum
ภราดร	fraternal
ช่างไม้	carpenter
ดอกเตอร์	doctor
su	su
gsub	gsub
สิม	shen
gat	gat
ครั่ง	lac
โกลบอล	global
ห่าน	goose
ra	ra
mol	mol
ลูกปัด	bead
xxx	xxx
ชาร์ล็อต	charlotte
คลื่นไส้	nauseous
คลื่นไส้	nausea
สบายใจ	comfort
สบายใจ	comfortable
ป่าช้า	crypt
ป่าช้า	cemetery
สันโดษ	solitary
สันโดษ	loner
หัตถ์	hand
สายใย	bond
กระถาง	pot
กระถาง	planter
กระถาง	potted
รังแก	bully
ถดถอย	regression
เพลย์บอย	playboy
เพลย์บอย	playboys
กำไล	bracelets
อึ	shit
แมต	matt
ธุรกรรม	transaction
ธุรกรรม	transactions
ปลวก	termites
ปลวก	termite
แผนภูมิ	chart
แผนภูมิ	charts
เช็ด	wipe
okrug	okrug
superior	superior
ทศนิยม	decimal
วิปริต	mischief
ฟุ่มเฟือย	extravagant
ฟุ่มเฟือย	luxury
ซิป	zipper
อินซูลิน	insulin
sts	sts
กันชน	bumper
คีม	clamp
คีม	pliers
คีม	forceps
jimmy	jimmy
ซาฟารี	safari
strong	strong
fontsize	fontsize
mega	mega
มอริเชียส	mauritius
ลูบ	pat
ลูบ	stroking
เลมอน	lemon
สัมภาระ	baggage
สัมภาระ	luggage
ti	ti
โปรเซสเซอร์	processors
เคท	kate
ปอม	pom
ลูกๆ	children
โม้	bragging
โม้	bragged
โม้	brag
โม้	boast
โครม	chrome
ชอย	choi
ไมโครโฟน	microphone
อุปสงค์	demand
เก๋ง	chic
เฉื่อย	slacking
เฉื่อย	inertia
แทรกซึม	infiltrate
น้ำปลา	sauce
เว็บเพจ	webpage
กระดิ่ง	bells
กระดิ่ง	bell
เดนเวอร์	denver
เฉยๆ	meh
จิงโจ้	kangaroo
pool	pool
สาธุ	amen
kamikaze	kamikaze
เชิงมุม	angular
megazord	megazord
อุน	eun
อบเชย	cinnamon
lotus	lotus
คอนโซล	console
manchester	manchester
mx	mx
zx	zx
ศัลยแพทย์	surgeon
ศัลยแพทย์	surgeons
cs	cs
nam	nam
ประทุน	convertible
อัณฑะ	testicle
นายทุน	investor
นายทุน	capitalist
โมเสก	mosaic
donald	donald
โฆษณาชวนเชื่อ	hype
โฆษณาชวนเชื่อ	propaganda
goodbye	goodbye
ดูว์	du
ฮับ	hubs
ฮับ	hub
wbf	wbf
งัน	ngan
พิถีพิถัน	meticulous
aus	aus
skin	skin
แชง	chang
ไอคอน	icons
ไอคอน	icon
canvas	canvas
palm	palm
มู่	mulan
โฉนด	deed
pol	pol
กระตุก	twitching
กระตุก	twitch
ceo	ceo
อัพเกรด	upgrade
โปรแกรมเมอร์	programmers
โปรแกรมเมอร์	programmer
บอลลูน	balloon
บอลลูน	balloons
กัญชา	pot
กัญชา	marijuana
กัญชา	weed
xbox	xbox
ดิ้นรน	struggling
ดิ้นรน	struggle
อวย	barrel
df	df
มาร์คัส	marcus
ทันตแพทย์	dentist
ทันตแพทย์	dentists
ทันตแพทย์	orthodontist
itunes	itunes
clean	clean
โค้ก	coke
เจือปน	contaminated
intercontinental	intercontinental
กอธ	goth
กอธ	gotham
ไลบรารี	library
yahoo	yahoo
baker	baker
jtwc	jtwc
นางนวล	seagull
cpu	cpu
ส้น	heels
ส้น	heel
คำราม	roar
toyota	toyota
สามง่าม	trident
เวด	wade
สิว	acne
สิว	pimples
สิว	pimple
ง่าม	pronged
ง่าม	prong
carbon	carbon
เชด	chase
บิง	bing
pu	pu
โปรย	scatter
สัญชาตญาณ	instinct
สัญชาตญาณ	intuition
lo	lo
แทร็ก	track
พฤหัส	thursdays
พฤหัส	thu
พฤหัส	thursday
แหวก	unconventional
fra	fra
billy	billy
ลัคกี้	lucky
labour	labour
ระแวง	paranoid
ไพน์	pint
blogspot	blogspot
โฟม	foam
โฟม	styrofoam
โกโก้	cocoa
phantom	phantom
adiantum	adiantum
wikitable	wikitable
gfdl	gfdl
ซาบซึ้ง	appreciate
ซาบซึ้ง	appreciated
ไคล์	kyle
คอร์ป	corps
mad	mad
hkt	hkt
iphone	iphone
iphone	iphones
น่อง	calves
น่อง	fibula
เปิ้ล	apples
มายด์	mind
cbt	cbt
คงกระพัน	invincible
คงกระพัน	impenetrable
คงกระพัน	invulnerable
เห่า	bark
เห่า	barks
เห่า	barking
ซีพียู	cpu
pd	pd
ln	ln
ชูชีพ	parachute
ส่าย	shake
hz	hz
โวหาร	eloquence
พัดลม	fan
เล้า	coop
tc	tc
rct	rct
smap	smap
chu	chu
สินบน	bribery
สินบน	bribes
สินบน	bribe
โยคะ	yoga
ลำเอียง	biased
อัพโหลด	upload
แตงกวา	cucumber
แตงกวา	cucumbers
ฟุ้ง	blowing
fanpage	fanpage
แส้	whip
แจ๊ซ	jazz
ia	ia
ม่านตา	pupils
lc	lc
หม้อแปลง	transformer
เอกพจน์	singular
พาเหรด	parade
ตื้อ	hassling
ตื้อ	persistent
ลูกขุน	jury
ลูกขุน	juror
สุภาษิต	proverbs
สุภาษิต	proverb
เย่	yay
เย่	yeah
โฮล์ม	holmes
การบ้าน	homework
ระลอก	ripples
อีกา	crow
bw	bw
uc	uc
คร่าวๆ	roughly
ปราชัย	defeat
ต้นสน	spruce
ต้นสน	pine
เด้ง	bouncing
เด้ง	bounce
แจกัน	vases
แจกัน	vase
มาเรียนา	mariana
factbook	factbook
จุลภาค	comma
จุลภาค	commas
กรรมพันธุ์	hereditary
กรรมพันธุ์	genetics
นิปปอน	nippon
นิกเกิล	nickel
สปาย	spy
counter	counter
ซอมบี้	zombie
เฮฮา	hilarious
gm	gm
ชาวไร่	peasant
ชาวไร่	farmer
ชาวไร่	farmers
ya	ya
บางๆ	thin
เหา	lice
ดิ้น	squirm
ตุน	stocked
ตุน	tun
subpage	subpage
ข้อศอก	elbow
ข้อศอก	elbows
แยม	yam
แยม	jam
ริดสีดวง	hemorrhoids
รกร้าง	desolation
รกร้าง	wilderness
โดนัท	donut
newsid	newsid
ไม้กวาด	brooms
ไม้กวาด	broom
jason	jason
las	las
แมงดา	pimp
lover	lover
dl	dl
sri	sri
liverpool	liverpool
direct	direct
หลวม	loose
อึดอัด	uncomfortable
อึดอัด	awkward
บูคาเรสต์	bucharest
bs	bs
แพลทินัม	platinum
ทูน่า	tuna
cathédrale	cathédrale
yale	yale
valenciennes	valenciennes
กระจกเงา	mirror
mn	mn
ไส้กรอก	sausage
ไส้กรอก	sausages
ไส้กรอก	wiener
งอกงาม	flourish
เบลอ	blurred
เบลอ	blurring
เบลอ	blurry
เบลอ	blur
ฟิลล์	phil
จูง	joo
wrestlemania	wrestlemania
precure	precure
günther	günther
holiday	holiday
ล่อลวง	seduced
ล่อลวง	beguiled
ล่อลวง	entice
ล่อลวง	seduce
สุดๆ	totally
barset	barset
vertex	vertex
concept	concept
คึกคัก	bustling
คุกกี้	cookies
คุกกี้	cookie
เหลียน	dalian
มั่ว	random
มั่ว	bs
suplex	suplex
meine	meine
วาบ	mindset
apr	apr
กระซิบ	whispering
กระซิบ	whisper
กระซิบ	whispers
ทริป	trip
flags	flags
นาส	nas
จิ้งจก	creeper
wikipedias	wikipedias
แท้ง	miscarriage
แท้ง	abortion
boss	boss
จิตแพทย์	shrink
จิตแพทย์	psychiatrist
เคาน์เตอร์	counter
ฟาเรนไฮต์	fahrenheit
ท่อม	thom
คาร์โล	carlo
primeminister	primeminister
ง่วง	sleepy
คร่ำ	amniotic
ใจร้าย	bitchy
nu	nu
nfpa	nfpa
แมตต์	matt
rom	rom
หาว	yawn
sankt	sankt
ไฟฉาย	flashlight
แฮงค์	hank
หลอมละลาย	melted
เปิดโปง	expose
dex	dex
rpm	rpm
จามรี	yak
บลูม	bluhm
บลูม	bloom
คลอรีน	chlorine
cap	cap
รายรับ	revenue
abs	abs
ประคำ	beads
ประคำ	rosary
fishbase	fishbase
ทรัมเป็ต	trumpet
ขอทาน	beggar
inchi	inchi
ผันผวน	fluctuating
ผันผวน	volatility
คิต	kit
kai	kai
xp	xp
lp	lp
wikidata	wikidata
โป้ง	poof
แร็พ	rap
ios	ios
ชาร์ป	sharp
ฉ้อฉล	embezzled
stdinchikey	stdinchikey
ทรวงอก	chests
ทรวงอก	thoracic
ทรวงอก	breasts
ไฟเบอร์	fiber
สำลี	lint
สำลี	swabs
ดุดัน	fierce
ดุดัน	wild
ดุดัน	aggressive
พังพอน	weasel
พังพอน	mongoose
กันแดด	sunscreen
fn	fn
zord	zord
สหภาพแรงงาน	union
สดชื่น	fresh
สดชื่น	lush
สดชื่น	refreshing
สดชื่น	refreshed
stdinchi	stdinchi
vcd	vcd
ns	ns
ef	ef
เชิงอรรถ	footnote
frameless	frameless
ulus	ulus
panthera	panthera
str	str
กระดุม	button
กระชาก	ripped
กระชาก	yank
ชีพจร	pulse
erectus	erectus
gen	gen
ทริส	tris
ริบบิ้น	ribbons
ริบบิ้น	ribbon
abovestyle	abovestyle
น้อยใจ	pining
squad	squad
คอนเนอร์	connor
ตำแหน่งที่ตั้ง	location
ตำแหน่งที่ตั้ง	locations
krai	krai
kw	kw
เตง	deng
ais	ais
ลี้ลับ	mystery
altvar	altvar
กิลเบิร์ต	gilbert
ไซเรน	sirens
ไซเรน	siren
tba	tba
android	android
sexy	sexy
สบายๆ	casual
สบายๆ	chilling
ถ่อม	humble
pet	pet
tg	tg
arg	arg
ไซส์	size
บูต	boot
บูต	boots
แซนด์วิช	sandwich
แซนด์วิช	sandwiches
อ่อนเพลีย	fatigue
อ่อนเพลีย	exhaustion
เบาะแส	clues
intel	intel
marvel	marvel
เคร็ก	craig
pg	pg
อาร์ท	art
อาร์ท	artsy
เนท	nate
ฮูก	owl
fl	fl
vie	vie
คาวบอย	cowboys
คาวบอย	cowboy
addclass	addclass
ซูชิ	sushi
รุ่งอรุณ	dawn
รุ่งอรุณ	daybreak
subdivision	subdivision
rf	rf
ffcc	ffcc
โหว่	cavity
โหว่	palate
ลินิน	linen
ค้ำจุน	sustain
fear	fear
นิ่ว	gallstones
bintang	bintang
ซาลาม	salaam
ซาลาม	salam
ข้าวต้ม	porridge
ข้าวต้ม	mush
ข้าวต้ม	congee
hip	hip
strike	strike
ล้นหลาม	overwhelming
กิ๊บ	barrette
ม้าม	spleen
ลูกรัง	dirt
แคะ	hakka
ace	ace
senior	senior
mapsize	mapsize
แฉ	exposing
wii	wii
ขลิบ	circumcision
ผ้าห่ม	blanket
ผ้าห่ม	blankets
ออนซ์	ounce
ออนซ์	ounces
ยุ่งเหยิง	messy
ยุ่งเหยิง	mess
โตโก	togo
designer	designer
เอื้อน	zap
เฮเลนา	helena
saga	saga
หงุดหงิด	upset
หงุดหงิด	moody
หงุดหงิด	frustrated
หงุดหงิด	irritated
gi	gi
โบว์ลิ่ง	bowling
schltr	schltr
พาดพิง	refer
ฝีเท้า	footsteps
ลิ้นจี่	lychee
ชุลมุน	herding
มังสวิรัติ	vegetarian
มังสวิรัติ	vegan
ภาวะฉุกเฉิน	emergency
คนนอก	outsider
ccc	ccc
คาห์น	kahn
ludwig	ludwig
พู่กัน	loafers
agg	agg
ประชากรศาสตร์	demographics
ประชากรศาสตร์	demographic
meson	meson
ล็อต	slot
ล็อต	slots
เอกสิทธิ์	privilege
interwiki	interwiki
nt	nt
อำมหิต	ruthless
quest	quest
fcw	fcw
ล็อค	lock
ล็อค	locked
ล็อค	locke
หล่ม	lom
ราคะ	lust
oz	oz
สายพาน	belt
andy	andy
mos	mos
เคิร์ก	kirk
เคมีภัณฑ์	chemical
cocktail	cocktail
เคิร์ต	kurt
เทรด	trade
robin	robin
fred	fred
suzuki	aff
wap	wap
toronto	toronto
โคม่า	coma
หมก	absorbing
ฟอเรสต์	forest
ค็อกเทล	cocktail
fanclub	fanclub
con	con
tp	tp
ซิลิคอน	silicon
ซูโม่	sumo
getargs	getargs
midi	midi
ultra	ultra
ฟักทอง	pumpkin
advance	advance
ประหนึ่ง	as
ผงาด	rises
แบม	bam
ไส้ติ่ง	appendix
ไส้ติ่ง	appendectomy
ward	ward
verlag	verlag
eve	eve
rca	rca
จอช	josh
สุดขีด	extreme
ช่องลม	vents
casno	casno
jo	jo
sons	sons
psi	psi
pat	pat
คำคม	quote
คำคม	quotes
อาบู	abu
cellspacing	cellspacing
batman	batman
กะหรี่	thot
กะหรี่	curry
กะหรี่	whores
ป๊อก	pok
chale	chale
smackdown	smackdown
โฉบ	foxtrot
nba	nba
oscar	oscar
ฟาวล์	fouls
ฟาวล์	foul
เบ้า	mold
ชีน	sheen
qf	qf
ยมโลก	underworld
ffd	ffd
แชมพู	shampoo
แมลงสาบ	cockroach
mnet	mnet
โนรี	reno
ffc	ffc
bg	bg
amazon	amazon
khz	khz
joy	joy
headerstyle	headerstyle
ntv	ntv
cuvier	cuvier
ขัดจังหวะ	interrupting
ขัดจังหวะ	interrupted
fref	fref
msn	msn
ssr	ssr
แอพ	app
แอพ	apps
ปลาวาฬ	whales
ปลาวาฬ	whale
ปลาวาฬ	orca
โฟล	flo
oricon	oricon
อะไหล่	parts
อดัมส์	adams
atc	atc
ksm	ksm
increment	increment
เงื่อน	knots
เงื่อน	knot
หวาดระแวง	paranoid
หวาดระแวง	paranoia
ut	ut
แทร็ค	track
beam	beam
เบียด	squeeze
นอกรีต	heresy
นอกรีต	heretic
นอกรีต	pagan
ติดใจ	addictive
แมงกานีส	manganese
ton	ton
wp	wp
lg	lg
va	va
kof	kof
เพลท	pelt
กำปั้น	fist
เสือดำ	panther
nick	nick
bf	bf
boulenger	boulenger
landmark	landmark
sg	sg
xiii	xiii
หล่า	rallies
แจน	jan
กำมะหยี่	velvet
ท่วมท้น	overwhelming
เฆี่ยน	cane
เฆี่ยน	flogged
ละอาย	shame
ละอาย	ashamed
โกลาหล	chaotic
boxing	boxing
เวอร์ชั่น	version
เวอร์ชั่น	versions
วังน้อย	noi
csstext	csstext
เจตจำนง	freewill
เบ็ต	beth
เคต	kate
โปร่งแสง	transparency
โปร่งแสง	transparent
โปร่งแสง	translucent
routledge	routledge
vn	vn
tm	tm
gnu	gnu
champ	champ
ปิงปอง	pong
canon	canon
เมอ	mer
เบรุต	beirut
cellpadding	cellpadding
แล่	carve
marc	marc
พิซซ่า	pizza
ประแจ	wrench
ประแจ	wrenches
สามชุก	chuk
หมกมุ่น	obsessive
หมกมุ่น	obsessed
สวัสดิภาพ	welfare
คลาสสิค	classical
คลาสสิค	classic
psp	psp
subtemplates	subtemplates
elegans	elegans
excel	excel
เหยา	yao
dom	dom
เงามืด	shadows
โวยวาย	rant
โวยวาย	ranting
bsd	bsd
เชิน	shen
เหี้ย	shite
sizedefault	sizedefault
bgc	bgc
กระเช้า	tram
riaa	riaa
rus	rus
inner	inner
แกลลอน	gallon
แกลลอน	gallons
expo	expo
jpn	jpn
serviceyears	serviceyears
rpg	rpg
av	av
สัมพันธภาพ	fellowship
directory	directory
สลด	tragic
ไซยาไนด์	cyanide
api	api
api	apis
หลาว	yards
ฉ้อโกง	fraud
เดค	dec
ยูน	yoon
sad	macintosh
saccade	saccade
ld	ld
จำนำ	pawned
จำนำ	hock
ลูป	loops
ลูป	loop
lisa	lisa
encyclopædia	encyclopædia
terry	terry
จักจั่น	cicada
uhfffaoysa	uhfffaoysa
ตะแกรง	grate
ตะแกรง	grates
แบนเนอร์	banners
แบนเนอร์	banner
เพนนี	penny
โกดัง	warehouse
ไตร่ตรอง	reflect
ไตร่ตรอง	ponder
ตะเกียบ	chopsticks
ตะเกียบ	chopstick
inter	inter
เหรัญญิก	treasurer
webcitation	webcitation
แซะ	sae
cx	cx
tiebreakers	tiebreakers
เกตเวย์	gateway
ชีค	sheik
vulpes	vulpes
cw	cw
rico	rico
สล็อต	slots
fit	fit
ลูกไก่	chick
คล้องจอง	rhyme
คล้องจอง	rhymes
สแลง	slang
อิซ	iz
jyp	jyp
โฮสต์	host
sas	sas
ซ่อง	brothel
mala	mala
โซฟา	sofa
โซฟา	couch
ตะปู	nail
ตะปู	nails
gymnothorax	gymnothorax
jon	jon
วิกลจริต	insane
liberty	liberty
gr	gr
chronicle	chronicle
จำนวนนับ	count
จำนวนนับ	counts
เยรูซาเล็ม	jerusalem
เกท	gate
kh	kh
nl	nl
ไดอารี่	diary
ไดอารี่	diaries
ผีดิบ	zombie
sepc	sepc
wan	wan
สันดาน	nature
luis	luis
ลูกอม	candy
authorlink	authorlink
พาราไดซ์	paradise
wikilinked	wikilinked
ประทุษร้าย	mayhem
rfc	rfc
kung	kung
หวด	whipping
หวด	swish
หวด	whip
ติดลบ	negative
messenger	messenger
xii	xii
รวมๆ	globally
ทางเท้า	curb
ทางเท้า	sidewalk
ทางเท้า	pavement
จักรราศี	zodiac
adff	adff
kottelat	kottelat
เริม	herpes
birthname	birthname
อุรังอุตัง	orangutan
tbd	tbd
พันธบัตร	bond
พันธบัตร	bonds
กริ่ง	doorbell
พืชพันธุ์	crops
bush	bush
จับใจ	captivated
บอบบาง	fragile
บอบบาง	delicate
เอ้อ	well
เอ้อ	uh
tnn	tnn
แวม	wham
lk	lk
bao	bao
fin	fin
รูท	root
firefox	firefox
เบ้าตา	orbital
เบ้าตา	sockets
ตอกย้ำ	remind
nbc	nbc
csi	csl
csi	csi
บั่นทอน	devastated
บั่นทอน	crippling
hiv	hiv
hl	hl
sec	sec
cctv	cctv
กิจวัตร	routine
js	js
usgs	usgs
geo	geo
ชะเอม	licorice
แดช	dash
ทังสเตน	tungsten
แซบ	zach
globe	globe
โมเด็ม	modem
โมเด็ม	modems
vj	vj
เผิง	peng
concat	concat
ฮอป	hop
fusca	fusca
บรู๊ค	brooke
ud	ud
feeling	feeling
ราล์ฟ	ralph
บรรณารักษ์	librarian
บรรณารักษ์	librarians
grammar	grammar
ทิ่ม	prick
kb	kb
roh	roh
tor	tor
ไถ่บาป	salvation
adams	adams
wright	wright
yamaha	yamaha
แท็บ	tabs
แท็บ	tab
sn	sn
แอ็กซ์	ax
inchikey	inchikey
moves	moves
ir	ir
ยาสีฟัน	toothpaste
โอเค	okay
โอเค	ok
มัลฟอย	malfoy
ตุ๋น	scammer
บิลเลียด	billiard
บิลเลียด	billiards
ใบสั่ง	ticket
excellence	excellence
โกลเด้น	golden
ทวีคูณ	multiply
lv	lv
cox	cox
แฮนด์บอล	handball
rc	rc
apg	apg
แคสเปียน	caspian
statement	statements
candy	candy
อั้ม	aum
ฟิตเนส	fitness
rgm	rgm
burn	burn
msg	msg
subsp	subsp
เคลีย	clea
senshi	senshi
ของกิน	grub
lt	lt
โอ๊ค	oaks
โอ๊ค	oak
เด็ค	dec
issn	issn
vegas	vegas
gui	gui
จุ๊บ	kisses
ub	ub
ลูว์	lew
คำขาด	categorical
สปริงฟิลด์	springfield
ชลอ	slowing
เต็นท์	tent
ak	ak
maptitle	maptitle
dee	dee
superman	superman
gsm	gsm
อนาธิปไตย	anarchists
อนาธิปไตย	anarchist
อนาธิปไตย	anarchy
sims	sims
mba	mba
แมนชั่น	mansion
งมงาย	ignorant
งมงาย	ignorance
งมงาย	superstitious
ขมขื่น	bitter
ขมขื่น	bitterness
เมตริก	metre
เมตริก	metric
micro	micro
null	null
usb	usb
unii	unii
alania	alania
roc	roc
tn	tn
กระสอบ	sacks
กระสอบ	sack
mono	mono
aq	aq
ยุทธภัณฑ์	ammunition
wikitech	wikitech
cdc	cdc
rb	rb
miami	miami
ฮอกไกโด	hokkaido
ฮั้ว	rigging
por	por
ul	ul
liststyle	liststyle
tin	tin
ui	ui
ขัดเกลา	purify
ประทัด	firecrackers
ประทัด	firecracker
โอลิมปิค	olympic
โอลิมปิค	olympian
justin	justin
ของชำ	grocery
ของชำ	groceries
steam	steam
copd	copd
แชมเปญ	champagne
เชง	cheng
ท้อแท้	frustrating
ท้อแท้	frustrated
ท้อแท้	discouraged
ซิลเวีย	sylvia
กระจกตา	cornea
aud	aud
gx	gx
subordo	subordo
orthographic	orthographic
wikia	wikia
หาเหตุ	bn
powerbomb	powerbomb
imf	imf
epa	epa
xa	xa
เรเน่	renee
ภราดรภาพ	brotherhood
รักแร้	armpits
รักแร้	armpit
dohc	dohc
gnome	gnome
javascript	javascript
marnay	marnay
dale	dale
exclusive	exclusive
คารวะ	homage
เอ๊ะ	eh
taxi	taxi
runner	runner
pad	pad
ศูนย์สูตร	equator
พันธนาการ	bondage
คนรวย	rich
เกาลัด	chestnut
เกาลัด	chestnuts
fw	fw
randy	randy
env	env
รีวิว	reviews
รีวิว	review
smtown	smtown
unity	unity
แมทท์	matt
ไวโอเล็ต	violet
ออซ	oz
acc	acc
kegg	kegg
croatia	croatia
corp	corp
เบ็ธ	beth
xl	xl
dodson	dodson
ทันใจ	instant
ใบปลิว	flyer
ใบปลิว	flyers
lightcurve	lightcurve
ชาวสวน	gardeners
corvus	corvus
pe	pe
สเปค	specification
สเปค	spec
สเปค	specs
ทะลัก	gutted
hk	hk
duo	duo
โต้วาที	debate
lm	lm
yume	yume
แรคคูน	raccoon
แรคคูน	raccoons
tot	tot
ศรัณ	saran
sms	sms
ฉูดฉาด	gaudy
mrna	mrna
อเดล	adele
โกเบ	kobe
เบ่ง	push
ถั่วงอก	sprouts
jose	jose
farm	farm
wikiproject	wikiproject
แฮง	hank
intensive	intensive
bss	bss
ซึมซับ	absorb
sb	sb
ดื้อยา	resistant
รีก	creek
gps	gps
slogan	slogan
ถอนพิษ	antidote
bloch	bloch
mh	mh
โล้น	bald
โล้น	balding
ยั่วยวน	seduce
uae	uae
ig	ig
roxb	roxb
sq	sq
totalcaps	totalcaps
ฟินน์	finn
วิจารณญาณ	discretion
totalgoals	totalgoals
โซดา	soda
gd	gd
ฉี่	pee
ปลั๊ก	plug
ปลั๊ก	plugs
ตูนิส	tunis
dm	dm
bl	bl
ลูกปืน	bullet
ประสาทหลอน	delusional
mergedtoprow	mergedtoprow
แครอท	carrot
แครอท	carrots
itemid	itemid
zen	zen
ubuntu	ubuntu
twelve	twelve
uca	uca
rocky	rocky
ส้อม	fork
ส้อม	cutlery
pin	pin
สลึง	dimes
จิตเวชศาสตร์	psychiatry
rgc	rgc
tcp	tcp
พีค	peak
iata	iata
ทัค	tuck
wordpress	wordpress
vc	vc
labelstyle	labelstyle
wikilink	wikilink
tb	tb
เม่า	moth
ฟู้ด	foods
โอ๊ต	oaks
โอ๊ต	oatmeal
โอ๊ต	oats
cfo	cfo
cev	cev
ขอยืม	borrow
efefef	efefef
obj	obj
โรคจิตเภท	schizophrenic
โรคจิตเภท	schizophrenia
wd	wd
ตระหง่าน	towering
snap	snap
monogatari	monogatari
ไรย์	rye
จักรภพ	universe
presenter	presenter
blu	blu
julia	julia
หูด	wart
หูด	warts
การุณย์	karun
wikisource	wikisource
zip	zip
สันทนาการ	rec
สันทนาการ	recreation
สันทนาการ	recreational
สันทนาการ	leisure
rtecs	rtecs
cad	cad
วอร์เรน	warren
za	za
gay	gay
xv	xv
ขยี้	crush
ขยี้	crushed
flickr	flickr
diva	diva
equus	equus
potato	potato
rh	rh
dancer	dancer
ฟิวส์	fuses
ฟิวส์	fuse
ein	ein
ทรอมโบน	trombone
dms	dms
เซธ	seth
จอยซ์	joyce
classe	classe
ทึ่ม	dork
cg	cg
sio	sio
ufo	ufos
ufo	ufo
ไม้บรรทัด	ruler
blossom	blossom
ยาบ้า	meth
สินสอด	dowry
hvdc	hvdc
pmid	pmid
textstyle	textstyle
vitamin	vitamin
เกียด	kia
จิตใต้สำนึก	subconscious
ขันติ	forbearance
เกี๊ยว	dumplings
เกี๊ยว	dumpling
userbox	userbox
bmw	bmw
yesno	yesno
lastevent	lastevent
ฟ้าร้อง	thunder
แม่หม้าย	widow
jurassic	jurassic
suv	suvs
suv	suv
เงื่อนงำ	clue
เงื่อนงำ	clues
dell	dell
obama	obamas
histoire	histoire
กระพือ	flapping
กระพือ	flap
เสือก	tiger
diuretics	diuretics
bts	bts
miguel	miguel
nextevent	nextevent
ดังๆ	loud
fx	fx
สิงค์	haunted
ไฮเวย์	highway
ชำแหละ	dissect
ชำแหละ	dissection
จู๋	penis
จู๋	dicks
จู๋	cock
lam	lam
ปิ๊ก	plectrum
แอบแฝง	ulterior
ประภาคาร	lighthouse
bp	bp
เบาๆ	gently
cleveland	cleveland
bjs	bjs
subheader	subheader
vip	vip
ดอกจัน	asterisk
kor	kor
ks	ks
andreas	andreas
sme	sme
char	jis
nk	nk
kj	kj
uf	uf
เหน็ดเหนื่อย	fatigue
ไมเกรน	migraine
ไมเกรน	migraines
ไนต์คลับ	nightclub
โผ	dart
timeaxis	timeaxis
render	render
โอ้อวด	flaunting
แคชเมียร์	cashmere
แคชเมียร์	kashmiri
แคชเมียร์	kashmir
โคลนนิ่ง	clone
โคลนนิ่ง	cloning
ทอร์เรส	torres
aves	aves
รีโมท	remote
nz	nz
ฮันท์	hunt
อิมเมจ	image
โคบอลต์	cobalt
infinity	infinity
คู่ควร	worthy
nancy	nancy
ยุ้ง	barn
อัลลอฮ์	god
ซุกซน	naughty
มึนเมา	intoxicated
มึนเมา	debauchery
มึนเมา	tipsy
agar	agar
rnai	rnai
คร่ำครวญ	moaning
superordo	superordo
lil	lil
michelle	michelle
บุคลิกลักษณะ	personality
mpls	mpls
echo	echo
nmb	nmb
pcr	pcr
โพลล์	polls
โพลล์	poll
โบลท์	bolt
credit	credit
ffe	ffe
nguyen	nguyen
ก๊อก	knock
ไฮไลท์	highlighted
ไฮไลท์	highlights
ไฮไลท์	highlight
seo	seo
springer	springer
สอย	shiv
rels	rels
ovw	ovw
ฮิป	hip
rt	rt
dk	dk
เครื่องร่อน	glider
มันเทศ	yam
reuters	reuters
สูติ	ob
langs	langs
polyhedra	polyhedra
mansi	mansi
khanty	khanty
เอื้อย	zap
confederations	confederations
prov	prov
ug	ug
macau	macau
rey	rey
copper	copper
ไดอะแกรม	diagrams
mas	mas
kt	kt
navbar	navbar
gc	gc
faq	faq
vt	vt
แฮมเบอร์เกอร์	hamburger
แฮมเบอร์เกอร์	hamburgers
ลีห์	leigh
กวาน	gwon
nj	nj
vaccinium	vaccinium
โลโล	lolo
sekai	sekai
เฮโรอีน	heroin
eg	eg
bezirk	bezirk
mrt	mrt
sting	sting
zhao	zhao
tmd	tmd
uv	uv
yg	yg
ci	ci
kpa	kpa
vols	vols
airplay	airplay
rchb	rchb
tar	tar
กะพริบ	blink
เอ็มม่า	emma
แบบสอบถาม	questionnaire
attitude	attitude
kami	kami
โรงรถ	garage
len	len
nest	nest
layout	layout
gadget	gadget
ภวังค์	trance
ภวังค์	unconsciousness
az	az
hrs	hrs
ซิงค์	synced
ซิงค์	sync
สร่าง	sober
มอร์ฟีน	morphine
เฟร็ด	fred
พูห์	pooh
ying	ying
neckbreaker	neckbreaker
โฟลเดอร์	folders
โฟลเดอร์	folder
pb	pb
bwv	bwv
hai	hai
rockman	rockman
fmri	fmri
ffa	ffa
รื่นรมย์	delightful
เมกะไบต์	mib
เมกะไบต์	megabytes
ky	ky
medaltemplates	medaltemplates
เท่ห์	cool
นุง	nung
ไขควง	screwdriver
bon	bon
ratp	ratp
exo	exo
ยุ่น	japs
ยุ่น	jap
sqmi	sqmi
premium	premium
mst	mst
exe	exe
pagasa	pagasa
alocasia	alocasia
tsunami	tsunami
สะดุ้ง	cringe
eest	eest
เดลาแวร์	delaware
ล้วนๆ	purely
sk	sk
หนุ่มๆ	boys
คาร์ไลล์	carlisle
arsenal	arsenal
bh	bh
กระโถน	potty
xiv	xiv
triumph	triumph
fujitv	fujitv
hotmail	hotmail
crest	crest
ridl	ridl
ฟีเจอร์	feature
ฟอยล์	tinfoil
ฟอยล์	foil
infoboxes	infoboxes
mbps	mbps
เคอร์เนล	kernel
mbs	mbs
แอสไพริน	aspirin
adm	adm
cash	cash
คอนโทรล	control
หดหู่	depressed
หดหู่	depressing
หดหู่	depression
aboveclass	aboveclass
boo	boo
hoya	hoya
transformers	exhibitions
fd	fd
gsd	gsd
สุขใจ	happy
io	io
ตุ๋ย	pedophile
boku	boku
ซูม	zoom
ncbi	ncbi
thesis	thesis
kc	kc
เทต	tate
utf	utf
sv	sv
jang	jang
rafflesiana	rafflesiana
โคเคน	coke
โคเคน	cocaine
เฮ่อ	pff
hr	hr
frozen	frozen
mammalia	mammalia
โพซิตรอน	positrons
initiative	initiative
mattis	mattis
plotarea	plotarea
เบ็ดเตล็ด	trivia
เบ็ดเตล็ด	misc
เบ็ดเตล็ด	miscellaneous
npc	npc
sysop	sysop
xyz	xyz
ดาการ์	dakar
wookieepedia	wookieepedia
safari	safari
tk	tk
รังสีวิทยา	radiology
โนห์	noh
transfermarkt	transfermarkt
ปลาบปลื้ม	ecstatic
rai	rai
โอ๊ย	ugh
dateformat	dateformat
dino	dino
ผวา	skittish
ชอล	chul
tattoo	tattoo
ละเมอ	sleepwalking
originaltitle	originaltitle
กุ๊กกิ๊ก	cuddling
เคฟ	kev
mev	mev
ด้ง	blowjob
กว้าน	winch
gpcm	gpcm
ท่องจำ	memorize
ei	ei
licensedtitle	licensedtitle
cichlidae	cichlidae
ping	ping
ping	pinged
melbourne	melbourne
nbn	nbn
undef	undef
lindl	lindl
บังเกอร์	bunker
vicepresident	vicepresident
อิสลามาบัด	islamabad
mia	mia
bride	bride
dp	dp
equiv	equiv
ภูเขาน้ำแข็ง	iceberg
chuck	chuck
ไฝ	mole
ไฝ	moles
zo	zo
lr	lr
petit	petit
noaa	noaa
สลิป	slip
cruz	cruz
finale	finale
maya	maya
dolby	dolby
tx	tx
gl	gl
เบลค	blake
jstor	jstor
เน็ด	ned
ล็อบบี้	lobby
ซ้าบ	saab
aki	aki
palestine	palestine
kate	kate
fhm	fhm
กรี๊ด	scream
pmc	pmc
อีเจียน	aegean
vita	vita
tdr	tdr
iaea	iaea
belowclass	belowclass
อือ	uh
ซิบ	zipper
โพส	post
โพส	pose
แฮ็ก	hacking
แฮ็ก	hacked
แฮ็ก	hack
icao	icao
นอกใจ	cheating
majeur	majeur
nextseason	nextseason
ขายส่ง	wholesaler
ขายส่ง	wholesale
sap	sap
dmy	dmy
einecs	einecs
puisne	puisne
บดขยี้	crushing
บดขยี้	crushed
textcolor	textcolor
mbk	downsize
licensor	licensor
rn	rn
neuroticism	neuroticism
wbu	wbu
โปสการ์ด	postcard
โปสการ์ด	postcards
หวงแหน	cherish
isp	isp
engl	engl
gpu	gpu
ทุบตี	beatings
cvt	cvt
เต๊ะ	satay
pframe	pframe
สปา	spa
สปา	spas
tbl	tbl
mbit	mbit
ลค	blake
chill	chill
cyp	cyp
cingulate	cingulate
origargs	origargs
pid	pid
nbt	nbt
duty	duty
sphrases	sphrases
prevseason	prevseason
คอรัปชั่น	corrupt
din	din
spd	spd
orbiter	orbiter
phylogeny	phylogeny
che	che
nabf	nabf
แพ็คเกจ	pack
แพ็คเกจ	plan
แพ็คเกจ	package
autocollapse	autocollapse
บอยด์	boyd
pk	pk
shopping	romantica
วอลเล่ย์	volleyball
sans	sans
acm	acm
โซนาร์	sonar
ccff	ccff
ก้ำกึ่ง	borderline
gym	gym
backbreaker	backbreaker
ncaa	ncaa
ช่ำชอง	skillful
ช่ำชอง	proficient
headman	headman
gk	gk
singlechart	singlechart
seventeen	seventeen
เซอร์ไพรส์	surprise
rune	rune
tw	tw
ars	ars
เสนารักษ์	corpsman
อาเมน	ameen
อาเมน	amen
ht	ht
ฟลอเรส	flores
qs	qs
เท็ต	tate
ความเฉื่อย	inertia
ฮาร์ป	harp
memphis	memphis
ดิ๊ก	dick
แคลอรี่	calorie
แคลอรี่	calories
โคมลอย	lanterns
univ	univ
bdfutbol	bdfutbol
efm	efm
พล็อต	plot
getparent	getparent
roca	roca
เป๊ะ	exactly
annie	annie
