celtic	celtic
iphone	iphone
mirabilis	mirabilis
aristida	aristida
genoa	genoa
nicole	nicole
orion	orion
arab	arab
logunov	logunov
eiffel	eiffel
stefan	stefan
huang	huang
bavaria	bavaria
newman	newman
lund	lund
gates	gates
sopron	sopron
myotis	myotis
bayer	bayer
rowclass	rowclass
subclassis	subclassis
federation	federation
speciosa	speciosa
lessert	lessert
solar	solar
yokosuka	yokosuka
amur	amur
radula	radula
croix	croix
ardahan	ardahan
elev	elev
francesco	francesco
derby	derby
aude	aude
tchad	chad
nash	nash
guốc	drops
guốc	clogs
vung	raised
vung	adjourned
vung	swing
edmund	edmund
gaddafi	gaddafi
usa}}	usa}}
python	python
microlepidoptera	microlepidoptera
cox	cox
beethoven	beethoven
theodor	theodor
wesley	wesley
forever	forever
sergey	sergey
aksaray	aksaray
catalunya	catalunya
catalunya	catalonia
hiv	hiv
franc	franc
franc	francs
percy	percy
said	said
heroes	heroes
barrett	barrett
choàng	cloak
hydrovatus	hydrovatus
grandiflora	grandiflora
havilland	havilland
wheeler	wheeler
venus	venus
emily	emily
mcdonnell	mcdonnell
luang	luang
ellis	ellis
reynolds	reynolds
tehran	tehran
eois	eois
krause	krause
brisbane	brisbane
brisbane	currie
brisbane	tasmania
pusilla	pusilla
guinness	guinness
niğde	bor
mun	mun
mun	husband
honolulu	honolulu
loew	loew
glee	glee
bulletin	bulletin
jamie	jamie
brad	brad
lena	lena
gran	gran
maiden	maiden
ipomoea	ipomoea
girard	girard
rumex	rumex
palma	palma
moran	moran
aspalathus	aspalathus
eye	eye
clayton	clayton
meliaceae	meliaceae
lazio	lazio
butterfly	butterfly
bae	bae
silent	silent
hirtz	hirtz
olympia	olympia
scn	scn
suk	suk
nevşehir	nevşehir
gaza	gaza
falcon	falcon
xylophanes	xylophanes
tyler	tyler
piô	pius
piô	pio
tulipa	tulipa
tucker	tucker
scandal	scandal
kerala	kerala
starcraft	starcraft
mohammed	mohammed
rubus	rubus
phai	fade
phai	phai
bates	bates
parsons	parsons
isabella	isabella
bufo	bufo
kingston	kingston
sowerby	sowerby
browning	browning
adia	adia
bayburt	bayburt
variegata	variegata
osprey	osprey
commercial	comercial
champa	champa
yorkshire	yorkshire
lowell	lowell
potsdam	potsdam
lươn	eel
lươn	eels
rex	rex
fbi	fbi
fbi	feds
apicalis	apicalis
marathon	marathon
ptolemy	ptolemy
cola	coke
cola	cola
host	cough
hutch	hutch
zamarada	zamarada
gibson	gibson
eryngium	eryngium
lốc	whirlwind
lốc	twister
debut	debut
peng	peng
truman	truman
pará	pará
stade	stade
poster	poster
poster	posters
motschulsky	motschulsky
windsor	windsor
goldman	goldman
ephemeris	ephemeris
hirsuta	hirsuta
arctia	arctia
đôla	dollars
kit	next
kit	kit
chơn	chon
perizoma	perizoma
sedan	sedan
lóng	slang
touch	touch
vichy	vichy
elena	elena
anolis	anolis
striata	striata
barbados	barbados
rossi	rossi
cresson	cresson
olympics	olympics
nagoya	nagoya
designer	designer
sặc	søren
reeve	reeve
rách	ripped
rách	pieces
rách	rags
carte	carte
vera	vera
calceolaria	calceolaria
hoffman	hoffmann
hoffman	hoffman
somerset	somerset
cbs	cbs
mohammad	mohammad
sasuke	sasuke
escobar	escobar
truk	truk
hydroporus	hydroporus
flava	flava
altai	altai
allan	allan
prey	prey
ural	ural
flavescens	flavescens
vệt	trails
steiermark	styria
steiermark	steiermark
jeanne	jeanne
diệc	heron
orlando	orlando
shinji	shinji
palais	palais
hübner	hübner
forst	forst
aim	aim
aim	alm
aim	ame
giorgio	giorgio
goku	goku
discolor	discolor
drilliidae	drilliidae
pit	pit
valeton	valeton
mordella	mordella
ver	ver
ver	alma
ver	val
messi	messi
yếm	bib
api	api
api	apis
ridge	ridge
cena	cena
walckenaer	walckenaer
kanji	kanji
magna	magna
lucius	lucius
subordo	subordo
mithridates	mithridates
script	script
navsource	navsource
alcis	alcis
reid	reid
rusby	rusby
hepburn	hepburn
ophrys	ophrys
sophia	sophia
montanus	montanus
iwo	iwo
aids	aids
ryu	ryu
yoshisada	yoshisada
salerno	salerno
győr	győr
mammillaria	mammillaria
mann	mann
latifolia	latifolia
villeneuve	villeneuve
cache	cache
ahmad	ahmad
cerro	cerro
dendrochilum	dendrochilum
hearts	hearts
rca	rca
karen	karen
chenopodium	chenopodium
randy	randy
agabus	agabus
tui	tui
gyrinus	gyrinus
euophrys	euophrys
brescia	brescia
bartram	bartram
miley	miley
maximus	maximus
alonso	alonso
xvii	xvi
carol	carol
tortricinae	tortricinae
parma	parma
hilliard	hilliard
nomi	nomi
phylogeny	phylogeny
deutschland	deutschland
morawitz	morawitz
grimmia	grimmia
jeong	jeong
garcinia	garcinia
flanders	flanders
acalypha	acalypha
oberea	oberea
salem	salem
aristolochia	aristolochia
thà	rather
thà	either
yamamoto	yamamoto
islam	islam
marino	marino
trotsky	trotsky
ios	ios
redir	redir
enzym	enzyme
penicillium	penicillium
lambert	lambert
gps	gps
canon	canon
fernández	fernández
reticulata	reticulata
kocaeli	kocaeli
mccain	mccain
igor	igor
funimation	funimation
macroglossum	macroglossum
badajoz	badajoz
heath	heath
micronesia	micronesia
scoreb	scoreb
nadal	nadal
rodr	rodr
tenuis	tenuis
cirsium	cirsium
trojan	trojan
mid	mid
hussein	hussein
acre	acre
sonata	sonata
bleeker	bleeker
súp	soup
levy	levy
dana	dana
ranunculus	ranunculus
ioc	ioc
domingo	domingo
keys	keys
sheffield	sheffield
isparta	isparta
burdur	burdur
perkins	perkins
miyazaki	miyazaki
barbarossa	barbarossa
deus	deus
xăm	tattooing
xăm	tattoo
xăm	tattooed
vernon	vernon
lexington	lexington
charleston	charleston
thảy	throw
thảy	threw
gerald	gerald
lanceolata	lanceolata
eden	eden
elseif	elseif
devon	devon
scapa	scapa
junkers	junkers
verdc	verdc
rumani	romanian
care	care
shipbuilding	shipbuilding
sikkim	sikkim
dacia	dacia
nina	nina
past	past
xiên	oblique
xiên	spear
ranidae	ranidae
gạc	antlers
gạc	gauze
gạc	swab
haven	haven
epilobium	epilobium
orientales	orientales
kén	cocoon
kén	chrysalis
wiley	wiley
fowler	fowler
göttingen	göttingen
ouest	ouest
mclean	mclean
hydriomena	hydriomena
monica	monica
aviv	aviv
rudy	rudy
trochidae	trochidae
bear	bjorn
tomentosa	tomentosa
eunidia	eunidia
loneos	loneos
rin	rin
liang	liang
sims	sims
felder	felder
annie	annie
taraxacum	taraxacum
pete	pete
vinci	vinci
ariadna	ariadna
longifolia	longifolia
piece	piece
pana	pana
hubble	hubble
hewitt	hewitt
meisn	meisn
thick	thick
nürnberg	nuremberg
antonius	antony
ibrahim	ibrahim
bazzania	bazzania
abbas	abbas
herman	herman
ashton	ashton
tripoli	tripoli
elbe	elbe
adm	adm
conrad	conrad
denver	denver
valentine	valentine
rhode	rhode
keynes	keynes
christine	christine
falkland	falkland
bung	expand
asti	asti
motors	motors
pisa	pisa
digitaria	digitaria
duncan	duncan
gigantea	gigantea
bombay	bombay
jenny	jenny
pouteria	pouteria
krishna	krishna
allocosa	allocosa
northrop	northrop
aurora	aurora
pulchra	pulchra
casa	casa
pat	pat
faunal	faunal
nachi	nachi
caussols	caussols
unicode	unicode
linkin	linkin
euclid	euclid
pike	pike
voronezh	voronezh
pasha	pasha
ieee	ieee
chói	brilliance
fokker	fokker
pearson	pearson
atriplex	atriplex
sysop	sysop
gladiolus	gladiolus
cantabria	cantabria
cebu	cebu
moson	moson
fast	stuck
lodovico	lodovico
voldemort	voldemort
lốp	tires
lốp	tyre
lốp	tire
parviflora	parviflora
lipotriches	lipotriches
liège	liège
modesta	modesta
popov	popov
concolor	concolor
geoffrey	geoffrey
bosch	bosch
lorentz	lorentz
namen	namen
twinkle	twinkle
natal	natal
cohen	cohen
fern	fern
moses	moses
gasteracantha	gasteracantha
poblacion	poblacion
apocynaceae	apocynaceae
memphis	memphis
mas	mas
chapman	chapman
cinnamomum	cinnamomum
pulchella	pulchella
thắn	mannerisms
anthidium	anthidium
eulophia	eulophia
norwich	norwich
alta	alta
clo	clo
clo	chlorine
adelaide	adelaide
ovulidae	ovulidae
delphinium	delphinium
angelo	angelo
nile	nile
metacritic	metacritic
clapton	clapton
messier	messier
dreams	dreams
sázavou	sázavou
nôi	cradle
huesca	huesca
hector	hector
ling	ling
fusca	fusca
maguire	maguire
kylie	kylie
cưng	dear
suez	suez
yorktown	yorktown
federer	federer
bofors	bofors
yunnanensis	yunnanensis
vụng	clumsy
dãi	drool
zombie	zombie
aphonopelma	aphonopelma
ichigo	ichigo
mẩu	ark
mẩu	sheet
mẩu	sheets
brien	brien
turn	gymnastics
hen	seriously
hen	asthma
tun	yard
tun	tun
volutidae	volutidae
shō	shō
plymouth	plymouth
hwa	hwa
cosmopterix	cosmopterix
anglo	anglo
palm	palm
montreal	montreal
fulham	fulham
auf	auf
root	root
boheman	boheman
cinerea	cinerea
žďár	žďár
portugal	portugal
nhổ	spits
nhổ	spitting
nhổ	spit
argiope	argiope
waterloo	waterloo
rành	connoisseur
citrus	citrus
halifax	halifax
germar	germar
milton	milton
mollis	mollis
kazan	kazan
serra	serra
cac	cac
cac	you
archer	archer
noel	noel
ritter	ritter
brooks	brooks
ferry	ferry
minima	minima
strauss	strauss
lóc	whining
naples	naples
emmanuel	emmanuel
allison	allison
guérin	guérin
jäger	jäger
lionel	lionel
orchidee	orchidee
cuvier	cuvier
trick	trick
mariah	mariah
aster	aster
dizionario	dizionario
oerlikon	oerlikon
rivera	rivera
curtiss	curtiss
serrata	serrata
tenerife	tenerife
borhidi	borhidi
thani	thani
machimus	machimus
vữa	mortar
burton	burton
catalan	catalan
rita	rita
giấm	vinegar
jtwc	jtwc
hua	hua
dawn	awn
anobiidae	anobiidae
latreille	latreille
float	float
hwang	hwang
khong	khong
rpg	rpg
sành	connoisseurs
proc	proc
compact	compact
cheng	hopeless
cheng	cheng
cyprinidae	cyprinidae
byelorussia	byelorussia
cornell	cornell
ribes	ribes
heller	heller
calyptranthes	calyptranthes
motor	motor
bandera	bandera
sat	sat
christoph	christoph
andersen	andersen
orchideen	orchideen
elisabeth	elisabeth
rouge	rouge
darius	darius
chiapas	chiapas
benfica	benfica
saxon	saxon
ngửa	backstroke
smithsonian	smithsonian
verhoeff	verhoeff
penn	penn
nhọc	hardships
nhọc	hardship
primates	primates
variabilis	variabilis
magnus	magnus
comarca	comarca
acontia	acontia
gyretes	gyretes
sục	power
abe	abe
dolomedes	dolomedes
ita}}	ita}}
hòm	ark
freeman	freeman
mọng	juicy
scleria	scleria
kurz	kurz
yan	yan
glabra	glabra
ramos	ramos
polo	polo
flores	flores
prairie	prairie
timothy	timothy
ieyasu	ieyasu
belur	belur
cloud	cloud
loét	sores
loét	ulcers
loét	ulcer
bernardo	bernardo
nbc	nbc
passiflora	passiflora
siemens	siemens
rotterdam	rotterdam
vừng	sesame
tằng	zeng
kiel	kiel
lamprosema	lamprosema
eublemma	eublemma
hikaru	hikaru
třebíč	třebíč
mcdonald	mcdonald
eminem	eminem
rim	rim
rim	rhyme
ferrara	ferrara
tryon	tryon
dido	dido
mượt	smooth
perth	perth
lev	lev
dmitri	dmitri
ozyptila	ozyptila
chad	chad
proceedings	proceedings
satsuma	satsuma
zagreb	zagreb
habronattus	habronattus
betula	betula
tesla	tesla
irish	irish
mayenne	mayenne
castilleja	castilleja
kun	kun
litsinger	litsinger
fishbase	fishbase
sấy	anchovies
sấy	dryer
sấy	drying
teamb	teamb
sitticus	sitticus
pine	pine
mol	moles
mol	mol
saussurea	saussurea
giăng	webs
abel	abel
palpita	palpita
barbus	barbus
jičín	jičín
trút	pouring
millidge	millidge
anatolia	anatolia
purpurea	purpurea
midlands	midlands
sterculia	sterculia
spam	spam
westwood	westwood
barack	barack
nitida	nitida
cardiff	cardiff
kerr	kerr
vaccinium	vaccinium
indo	indo
videos	videos
michener	michener
rubra	rubra
chat	chat
zen	zen
goth	goth
goth	gothic
scarlett	scarlett
derek	derek
belgrade	volgograd
belgrade	belgrade
teresa	teresa
đuốc	torches
đuốc	torch
bibliography	bibliography
schaus	schaus
tru	howling
tru	threaten
tru	tink
katy	katy
jeremy	jeremy
léon	léon
nakamura	nakamura
veronica	veronica
vision	vision
glenn	glenn
manning	manning
mận	plum
mận	plums
nách	pits
nách	armpit
nách	armpits
szlach	szlach
hartmann	hartmann
euphrasia	euphrasia
agrostis	agrostis
firenze	firenze
polish	polish
elvis	elvis
tegenaria	tegenaria
benson	benson
sting	sting
royce	royce
hesse	hesse
mayer	mayer
litoria	litoria
marcos	marcos
française	française
kırklareli	kırklareli
greenwood	greenwood
parks	parks
xốp	foam
ilyushin	ilyushin
sưởi	heaters
sưởi	mantel
fra}}	fra}}
holocaust	holocaust
lucien	lucien
lisbon	lisbon
arachnida	arachnida
reggio	reggio
eriogonum	eriogonum
hyderabad	hyderabad
opuntia	opuntia
dion	dion
kay	kay
paramount	paramount
ellen	ellen
benton	benton
baron	baron
hít	breathe
continental	continental
sato	sato
rus	rus
canaria	canaria
nexus	nexus
magiê	magnesium
kabul	kabul
còi	buzzer
còi	whistle
còi	whistles
pre	pre
preston	preston
phraya	phraya
emi	emi
ulithi	ulithi
luca	luca
aria	aria
börngen	börngen
saitama	saitama
jake	jake
acanthodelta	achaea
ferruginea	ferruginea
bel	bel
brabant	brabant
cave	cave
brandt	brandt
villosa	villosa
jensen	jensen
tito	tito
londt	londt
lille	lille
splendens	splendens
herrera	herrera
fairy	fairy
vahl	vahl
gustave	gustave
wembley	wembley
vale	vale
mustang	mustang
wwf	wwf
berger	berger
vulgaris	vulgaris
ballet	ballet
bali	balinese
bali	bali
click	click
malay	malay
burke	burke
sophronica	sophronica
habana	habana
baldwin	baldwin
glauca	glauca
gomez	gomez
diva	diva
mills	mills
vogel	vogel
katsuura	katsuura
exo	exo
aquila	aquila
riley	riley
prain	prain
aubl	aubl
apache	apache
swaziland	swaziland
ngất	swoon
ngất	fainted
thymus	thymus
kirk	kirk
villers	villers
dem	dem
bissau	bissau
warncke	warncke
cfg	cfg
humboldt	humboldt
mnet	mnet
angels	angels
cincinnati	cincinnati
stein	stein
jalisco	jalisco
linden	linden
ada	adda
ada	ada
albion	albion
wade	wade
strong	strong
wto	wto
gould	gould
morales	morales
pixar	pixar
campos	campos
kohl	kohl
gardens	gardens
quincy	quincy
ornata	ornata
shizuoka	shizuoka
mythimna	mythimna
paz	paz
dante	dante
pilosa	pilosa
gérard	gérard
fury	fury
savage	savage
maculatus	maculatus
hogwarts	hogwarts
oahu	oahu
acalolepta	acalolepta
moy	moy
gil	gil
cabo	cabo
tmesisternus	tmesisternus
jolie	jolie
rolls	rolls
lviv	lviv
summerh	summerh
rehder	rehder
kota	kota
bauhinia	bauhinia
alessandro	alessandro
ekman	ekman
log	log
parms	parms
springer	springer
barnard	barnard
sabre	sabre
thebes	thebes
claudius	claudius
tricolor	tricolor
schulz	schulz
bari	bari
guillaumin	guillaumin
plasma	plasma
versicolor	versicolor
sturm	sturm
nathan	nathan
avro	avro
taekwondo	taekwondo
shinsengumi	shinsengumi
turk	turk
patricia	patricia
minutus	minutus
eduard	eduard
bufonidae	bufonidae
yangon	yangon
calamus	calamus
enrique	enrique
strike	strike
asperula	asperula
elymus	elymus
ranger	ranger
yard	yard
bucharest	bucharest
konstantinos	constantine
int	int
shelby	shelby
shehbaz	shehbaz
eudonia	eudonia
opostegidae	opostegidae
lufthansa	lufthansa
taken	taken
rufus	rufus
connor	connor
dynamo	dynamo
harrier	harrier
caudata	caudata
hon	hon
hon	dear
ôliu	olive
ôliu	olives
nola	nola
liechtenstein	liechtenstein
shakira	shakira
sứa	jellyfish
benoit	benoit
rabaul	rabaul
richland	richland
atlantique	atlantique
cromwell	cromwell
queens	queens
plain	plain
cello	cello
robertson	robertson
ser	ser
rán	frying
rán	fry
quầy	chef
fungorum	fungorum
chionaema	cyana
hae	hae
maxon	maxon
dracula	dracula
endl	endl
metropolitan	metropolitan
capparis	capparis
vendée	vendée
tonga	tonga
marginellidae	marginellidae
andaman	andaman
territoire	territoire
pass	watch
pass	pass
baja	baja
dam	dam
yeltsin	yeltsin
lori	lori
canyon	canyon
malacca	malacca
lineata	lineata
walther	walther
christie	christie
oeste	oeste
eremophila	eremophila
dominique	dominique
garnier	garnier
ultimate	ultimate
dieu	dieu
gleason	gleason
crimean	crimea
crimean	crimean
chấu	locusts
quentin	quentin
marlborough	marlborough
uta	uta
fleet	fleet
prodcode	prodcode
tours	tours
reeder	reeder
calanthe	calanthe
macquart	macquart
girona	girona
hokkaido	hokkaido
tales	tales
canadensis	canadensis
maldives	maldives
rennes	rennes
castellón	castellón
javier	javier
brod	brod
sharon	sharon
rosario	rosario
rosea	rosea
suite	suite
erigone	erigone
rollins	rollins
rollins	rawlins
clair	clair
soricomorpha	soricomorpha
woodson	woodson
antwerp	antwerp
sevastopol	sevastopol
aurea	aurea
pseudopoda	pseudopoda
jeju	jeju
mirror	mirror
diếp	lettuce
cyclophora	cyclophora
macrophylla	macrophylla
potentilla	potentilla
lesotho	lesotho
aristotle	aristotle
maslin	maslin
ultra	ultra
xxx	xxx
arcade	arcade
ústí	ústí
kolkata	kolkata
reef	reef
wasp	wasp
boong	decks
boong	deck
spectabilis	spectabilis
furnariidae	furnariidae
riccardia	riccardia
pratt	pratt
andalusia	andalusia
lindau	lindau
franciscolo	franciscolo
kawasaki	kawasaki
bactria	bactria
amanda	amanda
malcolm	malcolm
joker	joker
yves	yves
gubbi	gubbi
mrkos	mrkos
goethe	goethe
winchester	winchesters
winchester	winchester
cnn	cnn
guillaume	guillaume
sericea	sericea
cúi	bend
juss	juss
thây	zombies
kant	kant
japonicus	japonicus
trifolium	trifolium
chum	chum
granit	granit
tanikawa	tanikawa
nhấp	clicked
nhấp	click
fallax	fallax
chronicle	chronicle
pumila	pumila
birdlife	birdlife
turku	turku
bradford	bradford
gaius	gaius
antilles	antilles
seki	seki
ekaterina	ekaterina
populus	populus
shark	shark
flagstaff	flagstaff
ein	ein
gymnopilus	gymnopilus
messina	messina
infraclassis	infraclassis
sếu	cranes
sếu	crane
mandela	mandela
ghe	ghe
metallica	metallica
ramírez	ramírez
kanagawa	kanagawa
burret	burret
scorea	scorea
asm	asm
xiếc	circus
dom	dom
gigas	gigas
dae	dae
altlink	altlink
erwin	erwin
belfast	belfast
brandegee	brandegee
linn	linn
picta	picta
joy	joy
haplochromis	haplochromis
verdun	verdun
macau	macau
sint	sint
tyrannidae	tyrannidae
erysimum	erysimum
argia	argia
bryansk	bryansk
columbellidae	columbellidae
hare	hare
littorinidae	littorinidae
jasper	jasper
nba	nba
tristis	tristis
plata	plata
phở	pho
trafford	trafford
affairs	affairs
emirates	emirates
terme	terme
sum	sum
swiss	swiss
aconitum	aconitum
chin	chin
clemson	clemson
himmler	himmler
ahn	ivanov
ahn	ahn
dĩa	plate
valenciennes	valenciennes
muang	muang
rna	rna
khoe	shows
düsseldorf	düsseldorf
düsseldorf	dusseldorf
maha	maha
usda	usda
lives	lives
tyson	tyson
scotopteryx	scotopteryx
sonic	sonic
johor	johor
agm	agm
dượng	vernon
dượng	stepfather
cecil	cecil
larvae	larvae
besançon	besançon
javascript	javascript
rzhev	rzhev
takeda	takeda
mercedes	mercedes
sigma	sigma
adventures	adventures
licania	licania
ryū	ryū
ubuntu	ubuntu
kagoshima	kagoshima
tallinn	tallinn
vito	vito
chintamani	chintamani
peruviana	peruviana
varese	varese
sparrow	sparrow
origins	origins
banh	ball
yucatán	yucatan
yucatán	yucatán
heli	helium
wakayama	wakayama
wii	wii
orléans	orléans
amazonas	amazonas
lutea	lutea
almería	almería
ponte	ponte
agamidae	agamidae
martínez	martínez
kmh	kmh
thames	thames
guadeloupe	guadeloupe
@yahoo	@yahoo
jma	jma
cumberland	cumberland
lamarck	lamarck
craugastor	craugastor
btr	btr
serv	serv
leslie	leslie
mụn	acne
mụn	pimple
mụn	pimples
kirby	kirby
catasetum	catasetum
mustafa	mustafa
zona	zona
romero	romero
messerschmitt	messerschmitt
cardamine	cardamine
caradrina	caradrina
pittsburgh	pittsburgh
saladin	saladin
nigrescens	nigrescens
asturias	asturias
weimar	weimar
synonym	synonym
yoshida	yoshida
vaughan	vaughan
seydlitz	seydlitz
gauss	gaussian
gauss	gauss
sakhalin	sakhalin
esp}}	esp}}
banner	paths
banner	banner
pallas	pallas
seth	seth
regia	regia
wikidata	wikidata
pao	lbs
pao	pao
mega	mega
tơi	fixes
mindanao	mindanao
nigricans	nigricans
claire	claire
maru	maru
trias	trias
mallinella	mallinella
meridionalis	meridionalis
hessen	hessen
africanus	africanus
heliconia	heliconia
hindi	hindi
tango	tango
quýnh	jiong
tribus	tribus
montréal	montreal
desmodium	desmodium
makoto	makoto
dubia	dubia
thank	thank
empires	empires
jesse	jesse
walsh	walsh
hey	hey
adrian	adrian
indicus	indicus
xylocopa	xylocopa
kagome	kagome
prescott	prescott
ark	ark
albrecht	albrecht
marsh	marsh
govaerts	govaerts
suwon	suwon
gómez	gomez
gómez	gómez
leach	leach
višnjan	višnjan
coldplay	coldplay
české	české
olga	olga
carnegie	carnegie
kwon	kwon
dyar	dyar
yamaguchi	yamaguchi
brit	britt
brit	brit
rod	rod
pseudagrion	pseudagrion
bờm	mane
crepis	crepis
hermione	hermione
phẩy	comma
zeno	zeno
mussolini	mussolini
amazing	amazing
nhờn	oily
nhờn	greasy
joshua	joshua
earl	earl
demetrios	demetrius
amber	amber
nhk	nhk
montevideo	montevideo
combretum	combretum
neon	neon
hoon	hoon
kenny	kenny
pallidus	pallidus
hanoi	hanoi
richter	richter
gamble	gamble
shiki	shiki
kurd	kurdish
kurd	kurd
mercer	mercer
bethlehem	bethlehem
bolt	bolt
invincible	invincible
sidi	sidi
mainz	mainz
pygmaea	pygmaea
moure	moure
tracy	tracy
imf	imf
lactuca	lactuca
lacon	lacon
blanchard	blanchard
mickey	mickey
natalensis	natalensis
grenada	grenada
uesac	uesac
xml	xml
noctuinae	noctuinae
antigua	atikokan
antigua	antigua
claudia	claudia
shogun	shogun
aung	aung
toei	toei
dynamics	dynamics
disa	disa
stella	stella
sunda	sunda
sunda	sundae
stoke	stoke
prasinocyma	prasinocyma
baku	baku
car	car
eduardo	eduardo
quăng	throw
yen	yen
sedis	sedis
werder	werder
seal	seal
elliot	elliot
pasteur	pasteur
albany	albany
achaea	achaea
nesom	nesom
decipiens	decipiens
bloch	bloch
yoga	yoga
albacete	albacete
blade	blade
gundam	gundam
mat	food
mat	mat
ectropis	ectropis
nuevo	nuevo
nol	nol
disco	disco
prószyński	prószyński
rufa	rufa
heinkel	heinkel
pounder	pounder
gsub	gsub
asp	asp
penny	penny
agrochola	agrochola
shadab	shadab
yuki	yuki
namedata	namedata
blackwall	blackwall
quýt	mandarin
quýt	tangerine
sunni	sunni
eve	ev
eve	eve
minamoto	minamoto
node	node
hacker	hacker
hacker	hackers
hacker	hack
sendai	sendai
tiberius	tiberius
christophe	christophe
ming	ming
engels	engels
znojmo	znojmo
xúi	jinx
lynn	lynn
olomouc	olomouc
durham	durham
chae	chae
anomis	anomis
chong	chong
hót	singing
hót	sings
coloma	coloma
thor	thor
sandbox	sandbox
padova	padua
padova	padova
ovata	ovata
incertae	incertae
ruby	ruby
dwight	dwight
selena	salina
selena	selena
comoros	comoros
fulton	fulton
palustris	palustris
xavier	xavier
blücher	blücher
candy	candy
superordo	superordo
sheridan	sheridan
pauly	pauly
xòe	tutu
broun	broun
griffin	griffin
fao	fao
iğdır	iğdır
vtc	vtc
menzies	menzies
khuấy	stirred
khuấy	stir
konstantin	konstantin
boa	boa
cube	cube
r}}	r}}
emil	emil
rahman	rahman
glen	glen
klaus	klaus
gorbachev	gorbachev
resort	resort
corinna	corinna
benz	benz
hampton	hampton
chandler	chandler
williamson	williamson
pers	pers
papilionidae	papilionidae
göring	goering
göring	göring
nordrhein	nordrhein
samar	samar
quinn	quinn
taira	taira
castel	castel
bmw	bmw
sumer	sumerian
irene	irene
cartoon	cartoon
penang	penang
gớm	inflammation
zeller	zeller
scheer	scheer
oberösterreich	oberösterreich
vocals	vocals
kahn	kahn
toro	toro
gaon	gaon
sủa	bark
sủa	barks
sủa	barking
carr	carr
fpt	fpt
betty	betty
wilkinson	wilkinson
cholesterol	cholesterol
constantinople	constantinople
allmusic	allmusic
chihuahua	chihuahua
chihuahua	chihuahuas
ancona	ancona
descartes	descartes
tran	tran
madeira	madeira
micro	micro
micro	microphone
thìa	spoons
thìa	spoon
bath	bath
cristata	cristata
blanc	blanc
medici	medici
gien	genes
gien	gene
cornwall	cornwall
uae	uae
scharnhorst	scharnhorst
bains	bains
confusa	confusa
luzula	luzula
androsace	androsace
marche	marche
bremer	bremer
hormone	hormone
hormone	hormones
udine	udine
michx	michx
kan	kạn
kan	kan
gập	folding
lens	lens
lens	leak
beirut	beirut
hahn	hahn
yamada	yamada
linearis	linearis
carabus	carabus
dot	dot
andersson	andersson
elip	ellipse
lafayette	lafayette
willem	willem
tatar	tatar
boom	bang
boom	boom
luigi	luigi
polygonum	polygonum
boone	boone
tetramorium	tetramorium
dumbledore	dumbledore
reo	rang
reo	doubt
reo	ringing
garrison	garrison
brunnea	brunnea
khun	khun
fiction	fiction
sidney	sidney
repens	repens
zelotes	zelotes
musashi	musashi
bosmans	bosmans
pluto	pluto
adobe	adobe
lexikon	lexikon
shizuka	shizuka
lindsey	lindsey
hyundai	hyundai
direct	direct
primula	primula
hochst	hochst
vermont	vermont
sụn	cartilage
craven	craven
gymnoscelis	gymnoscelis
kato	kato
nomura	nomura
diane	diane
thrace	thrace
rivière	rivière
borealis	borealis
anders	anders
sugar	sugar
hypercompe	hypercompe
bouchet	bouchet
evarcha	evarcha
doc	doc
dianthus	dianthus
budějovice	budějovice
khalip	caliph
antiochos	antiochus
schalke	schalke
kyushu	kyushu
phidippus	phidippus
cremona	cremona
handel	handel
turing	turing
talbot	talbot
piston	pistons
piston	piston
